#lng2name_EN
Berber=ber
Hawaiian\ Pidgin=hwc
Sesotho=st
Old\ Swedish=sv
Old\ Frisian=ofs
Waray-Waray=war
Sobian=wen
Veps=vep
Norfolk=pih
Norfuk=pih
Ilokano=ilo
Jèrriais=roa-jer
Massachusett=wam
Dena'ina=tfn
Ammonite=sem-amm
Alutiiq=ems
Miskito=miq
Gullah=gul
Mapudungun=arn
Flemish=vls
Acholi=ach
Kapampangan=pam
Mangarevan=mrv
Tocharian\ B=txb
Tocharian\ A=xto
Luganda=lg
Abenaki=abe
Proto-Indo-European=ine-pro
Sydney=aus-syd
Ilocano=ilo
Guugu\ Yimidhirr=kky
Adnyamathanha=adt
Yup'ik=ems
Tokelauan=tkl
Aynu=ayn
Lombardic=lmo
Slovene=sl
Livonian=liv
Acehnese=ace
Ojibwe=oj
Romansch=rm
Istro-Romanian=ruo
Shoshone=shh
Saterland\ Frisian=frs
Tuvaluan=tvl
Zazaki=zza
Azeri=az
American\ Sign=ase
Akkala\ Sami=sia
Avar=av
Ter\ Sami=sjt
Okinawan=ryu
Pite\ Sami=sje
Bemba=bem
Old\ Dutch=odt
Luwian=hlu
Old\ Prussian=prg
Ancient\ Greek=grc
Amuzgo=azg
Mauritian\ Creole=lsy
Ambonese\ Malay=abs
Romani=rmn
\!Kung=kfl
Algerian\ Saharan\ Arabic=aao
Old\ Provençal=pro
Old\ Danish=da
Algerian\ Arabic=arq
Guaraní=gun
Megleno-Romanian=ruq
Yucatec\ Maya=msd
Konkani=kok
Kildin\ Sami=sjd
Middle\ High\ German=gmh
Fang=fan
Old\ High\ German=goh
Gwich'in=gwi
Middle\ English=enm
Old\ Norse=non
Ancient\ Macedonian=xmk
Istro=ruo
Ainu=aib
Nahuatl=nah
Limburgish=li
Alabat\ Island\ Agta=dul
Chinook\ Jargon=chn
Jamaican\ Creole=jam
O'odham=ood
Mandarin\ Chinese=zh
Mandarin=zh
Greek=el
Abkhaz=ab
Khmer=km
Ume\ Sami=sju
Kemi\ Sami=sjk
Yupik=esu
Mende=sim
Old\ Spanish=es
Interlingua=ia
Old\ Saxon=osx
Alcozauca\ Mixtec=xta
Middle\ French=fr
Sotho=st
Cappadocian\ Greek=cpg
Proto-Germanic=de
Gaulish=xcg
Nama=naq
Middle\ French=frm
Old\ French=fro
#Tue Apr 10 01:09:46 CEST 2012
Zapotec,\ Santiago\ Xanica=zpr
Woun\ Meu=noa
Paluan=plz
Chin,\ Mün=mwq
Lehalurup=urr
Kendem=kvm
Tinigua=tit
Putai=mfl
Ajyíninka\ Apurucayali=cpc
Rema=bow
Andarum=aod
Quiché,\ West\ Central=qut
Pongu=png
Avokaya=avu
Mogum=mou
Wolof=wo
Onin\ Based\ Pidgin=onx
Vandalic=xvn
Ndali=ndh
Mator-Taygi-Karagas=ymt
Agutaynen=agn
Gengle=geg
Keak=keh
Reli=rei
Aheu=thm
Napu=npy
Unua=onu
Mozarabic=mxi
Modern\ Greek=el
Iowa-Oto=iow
Sanumá=xsu
Lahu\ Shi=lhi
Dusun\ Malang=duq
Mochica=omc
Bariai=bch
Nancere=nnc
Ndaka=ndk
Lycian=xlc
Vlaamse\ Gebarentaal=vgt
Mandari=mqu
Kinuku=kkd
Pankararú=paz
Larantuka\ Malay=lrt
Tamang,\ Northwestern=tmk
Rembong=reb
Usaghade=usk
Boor=bvf
Baruya=byr
Mandara=tbf
Lavatbura-Lamusong=lbv
Boon=bnl
Lakona=lkn
Hulung=huk
Gade=ged
Dompo=doy
Wolani=wod
Pankararé=pax
Bauria=bge
Wolane=wle
Cora,\ El\ Nayar=crn
Nukak\ Makú=mbr
Sénoufo,\ Nanerigé=sen
Nihali=nll
Chácobo=cao
Yangum\ Dey=yde
Kwakum=kwu
Tibetan,\ Old=otb
Bali\ (Democratic\ Republic\ of\ Congo)=bcp
Mina\ (India)=myi
Kariyarra=vka
Boni=bob
Polonombauk=plb
Fiji\ Hindi=hif
Yakaikeke=ykk
Sindhi\ Bhil=sbn
Noric=nrc
Sekar=skz
Yuaga=nua
Bobo\ Madaré,\ Southern=bwq
Dogon,\ Toro\ Tegu=dtt
Ila=ilb
Chuanqiandian\ Cluster\ Miao=cqd
Ojibwa,\ Central=ojc
Bomu=bmq
Obokuitai=afz
Erromintxela=emx
Manobo,\ Agusan=msm
Namo=mxw
Uyghur=ug
Kurdish,\ northern=kmr
A-Pucikwar=apq
Yakima=yak
Alekano=gah
Iko=iki
Wandamen=wad
Kuikúro-Kalapálo=kui
Airoran=air
Boma=boh
Sabanês=sae
Purepecha,\ Western\ Highland=pua
Chin,\ Daai=dao
Cayuse=xcy
Ika=ikk
Waxianghua=wxa
Mualang=mtd
Araweté=awt
Nalu=naj
Baga\ Kaloum=bqf
Skagit=ska
Weliki=klh
Aulua=aul
Pamona=pmf
Chinese\ Sign\ Language=csl
Turkish\ Sign\ Language=tsm
Gaam=tbi
Bolo=blv
Temein=teq
Buhutu=bxh
Apache\ (Jicarilla)=apj
Nali=nss
Bikya=byb
Kare\ (Papua\ New\ Guinea)=kmf
Akoye=miw
Mbala=mdp
Ifè=ife
Bole=bol
Tetete=teb
Ninggerum=nxr
Nkari=nkz
Bola=bnp
Shangzhai=jih
Kenyi=lke
Senoufo,\ Cebaara=sef
Parecís=pab
Tutchone,\ Southern=tce
Maricopa=mrc
Thai\ (Northern)=nod
Khlula=ykl
Wolio=wlo
Sardinian,\ Gallurese=sdn
Spanish,\ Loreto-Ucayali=spq
Ratahan=rth
Pokomo,\ Upper=pkb
Taungyo=tco
Mandobo\ Atas=aax
Naki=mff
Irish\ (Ireland)=ga
Kanembu=kbl
Nake=nbk
Bonkeng=bvg
Zimba=zmb
Malayalam=ml
Ponam=ncc
Falam\ Chin=flm
Naasioi=nas
Tukpa=tpq
Mintil=mzt
Fulfulde,\ Borgu=fue
Babanki=bbk
Wik-Ngathana=wig
Apali=ena
Gelao,\ Green=giq
Croatian=scr
Nakara=nck
Mayaguduna=xmy
Lule\ Sami=smj
Ningera=nby
Sikkimese=sip
Catalan\ (Spain)=ca
Marathi,\ Old=omr
Chaima=ciy
Apache\ (Mescalero-Chiricahua)=apm
Vao=vao
T'en=tct
Natagaimas=nts
Kulung\ (Nepal)=kle
Malila=mgq
Maremgi=mrx
Reel=atu
Duungooma=dux
Iha=ihp
Chipaya=cap
Oune=oue
Jebero=jeb
Vai=vai
Arabic\ (Eastern\ Egyptian\ Bedawi)=avl
Mina\ (Cameroon)=hna
Italian\ (Italy)=it
Kotava=avk
Tahltan=tht
Libido=liq
Guyanese\ Creole\ English=gyn
Sabüm=sbo
Igo=ahl
Kawacha=kcb
Zapotec,\ Mitla=zaw
Mopán\ Maya=mop
Lama\ (Togo)=las
Khehek=tlx
Lele\ (Chad)=lln
Laura=lur
Malay,\ Baba=mbf
Kibiri=prm
Koiwat=kxt
One,\ Molmo=aun
Bunu,\ Younuo=buh
Gbe,\ Saxwe=sxw
Archi=aqc
Huba=hbb
Ouma=oum
Naka'ela=nae
Dawera-Daweloor=ddw
Kara\ (Tanzania)=reg
Benabena=bef
Kemtuik=kmt
Ifo=iff
Kohistani,\ Indus=mvy
Mayangna=yan
Liana-Seti=ste
Arabic\ (Hijazi)=acw
Kuskokwim,\ Upper=kuu
Arabic=ar
Nnam=nbp
Marwari\ (Pakistan)=mve
Silopi=xsp
Kenyah,\ Sebob=sib
Pidgin,\ Cameroon=wes
Yeni=yei
Okpe\ (Southwestern\ Edo)=oke
Ngombe\ (Central\ African\ Republic)=nmj
E'ma\ Buyang=yzg
Võro=vro
Mesaka=iyo
Gorowa=gow
Okanagan=oka
Nage=nxe
Yi,\ Azhe=yiz
Uare=ksj
Nkami=nkq
Afro-Seminole\ Creole=afs
Latvian=lv
Literary\ Chinese=lzh
Gorovu=grq
Mashi\ (Nigeria)=jms
Boga=bvw
Gimnime=gmn
Makhuwa-Saka=xsq
Maskoy\ Pidgin=mhh
Montol=mtl
Babango=bbm
Gadaba,\ Pottangi\ Ollar=gdb
Qiubei\ Zhuang=zqe
Tsakonian=tsd
Turung=try
Guanche=gnc
Mandaic=mid
French\ (Switzerland)=fr
Khengkha=xkf
Nafi=srf
Ido=io
Bofi=bff
Dagoman=dgn
Ukhwejo=ukh
Idi=idi
Fulfulde,\ Bagirmi=fui
Tumzabt=mzb
Manobo,\ Cinamiguin=mkx
Upper\ Baram\ Kenyah=ubm
Kalinga,\ Butbut=kyb
Paniya=pcg
Tanapag=tpv
Huastec,\ San\ Luís\ Potosí=hva
Kalispel-Pend\ d'Oreille=fla
Moronene=mqn
Yele=yle
Ponares=pod
Yahadian=ner
Yela=yel
Tswa=tsc
Maligo=mwj
Sumariup=siv
Aka-Jeru=akj
Quichua,\ Chimborazo\ Highland=qug
Nakama=nib
Mungaka=mhk
Jandavra=jnd
Awara=awx
Martuyhunira=vma
Panamint=par
Norwegian\ Sign\ Language=nsl
Ibino=ibn
Lembata,\ West=lmj
Tengger=tes
Cerma=cme
Wajarri=wbv
Umpqua,\ Upper=xup
Vute=vut
Brazilian\ Sign\ Language=bzs
Tsuvan=tsh
Nzima=nzi
Muniche=myr
Malay,\ Kedah=meo
Ibu=ibu
Kurumba,\ Alu=xua
Dargwa=dar
Nahuatl,\ Isthmus-Mecayapan=nhx
Djingili=jig
Belhariya=byw
Saramaccan=srm
Tetela=tll
Bolongan=blj
Tsum=ttz
Apiacá=api
Iau=tmu
Miani=pla
Emberá-Catío=cto
Sáliba=slc
Madang=mqd
Kamakan=vkm
Ibilo=ibi
Romano-Greek=rge
Skolt\ Sami=sms
Tibetan,\ Amdo=adx
Bikol=bik
Agta,\ Isarog=agk
Uya=usu
Ukrainian=uk
Miami=mia
Sukuma=suk
Javanese=jv
Nabi=mty
Zangwal=zah
Ojibwa,\ Western=ojw
Mixtec,\ San\ Miguel\ Piedras=xtp
Shuwa-Zamani=ksa
Naba=mne
Kambera=xbr
Yamongeri=ymg
Bete-Bendi=btt
Buwal=bhs
Maridan=zmd
Okpamheri=opa
Kayan,\ Murik=mxr
Xerénte=xer
Dzao\ Min=bpn
Otomi,\ Tilapa=otl
Agta\ (Mt.\ Iraya)=atl
Otank=uta
Sicanian=sxc
Tulu-Bohuai=rak
Carijona=cbd
Mohawk=moh
Naga,\ Liangmai=njn
East\ Berawan=zbe
Wakhi=wbl
Lauje=law
Kurrama=vku
Ushojo=ush
Raute=rau
Bella\ Coola=blc
Uradhi=urf
Kumalu=ksl
Awngi=awn
Mayogo=mdm
Katawixi=xat
Befang=bby
Pambia=pmb
Dombe=dov
Latundê=ltn
Gilima=gix
Cayuga=cay
Laiyolo=lji
Chatino,\ Eastern\ Highland=cly
Gbe,\ Gbesi=gbs
Patla-Chicontla\ Totonac=tot
Teke,\ Ibali=tek
Mohave=mov
Picard=pcd
Aimol=aim
Mongol=mgt
Playero=gob
Amapá\ Creole=amd
Mixtec,\ Ayutla=miy
Mamaindé=wmd
Thangmi=thf
Breton,\ Middle=xbm
Ngäbere=gym
Sabine=sbv
Goaria=gig
Safwa=sbk
Muyuw=myw
Tzotzil,\ Venustiano\ Carranza=tzo
Koryak=kpy
Anglo-Norman=xno
Warrgamay=wgy
Jarawa\ (India)=anq
Dogon,\ Walo\ Kumbe=dwl
Senoufo,\ Palaka=plr
Koraga,\ Mudu=vmd
Tamasheq=taq
Dogon,\ Tomo\ Kan=dtm
Tamashek=tmh
German\ Sign\ Language=gsg
Lithuanian\ Sign\ Language=lls
Guwamu=gwu
Ayta\ (Sorsogon)=ays
Bassa-Kontagora=bsr
Mser=kqx
Piemontese=pms
Kara\ (Central\ African\ Republic)=kah
Garza=xgr
Mixtec,\ Itundujia=mce
Gafat=gft
Baka\ (Sudan)=bdh
Quechua,\ Ambo-Pasco=qva
Lawangan=lbx
Fiwaga=fiw
Miwok,\ Plains=pmw
Old\ English=ang
Utu=utu
Bunama=bdd
Klingon=tlh
Tharu,\ Kathoriya=tkt
Tsou=tsu
Parachi=prc
Panjabi=pa
Ghotuo=aaa
Pashayi,\ Northeast=aee
Southern\ Muji=ymc
Malalamai=mmt
Mo'da=gbn
Izi-Ezaa-Ikwo-Mgbo=izi
Djawi=djw
Koresh-e\ Rostam=okh
Baruga=bjz
Tepehuan,\ Southeastern=stp
Epena=sja
Tsoa=hio
Tangut=txg
Elpaputih=elp
Wakde=wkd
Kissi,\ Northern=kqs
Tonga\ (Tonga\ Islands)=to
Tobelo=tlb
Raeto-Romance=rm
Davawenyo=daw
Aushiri=avs
Afghan\ Sign\ Language=afg
Lakondê=lkd
Catalan=ca
Gbiri-Niragu=grh
Tsishingini=tsw
Lubila=kcc
Kemiehua=kfj
Mfumte=nfu
Angal\ Heneng=akh
Degenan=dge
Torau=ttu
Tenharim=pah
Bote-Majhi=bmj
Toram=trj
Konjo,\ Highland=kjk
Umbugarla=umr
Uru=ure
Arop-Lukep=apr
Sebat\ Bet\ Gurage=sgw
Hmong=hmn
Solong=aaw
Hya=hya
Uri=uvh
Thu\ Lao=tyl
Awiyaana=auy
Ngadjunmaya=nju
Sindhi=sd
Maskelynes=klv
Arosi=aia
Kwara'ae=kwf
Agoi=ibm
Tecpatlán\ Totonac=tcw
Eteocypriot=ecy
Mixtec,\ Tamazola=vmx
Nehan=nsn
Semaq\ Beri=szc
Agob=kit
Gureng\ Gureng=gnr
Awadhi=awa
Koyukon=koy
Ipeka-Tapuia=paj
Masai=mas
Dutch,\ Old=odt
Ghale,\ Southern=ghe
Ifugao,\ Mayoyao=ifu
Yinglish=yib
Arabic\ (North\ Levantine)=apc
Songhay,\ Humburi\ Senni=hmb
Celtiberian=xce
Sango,\ Riverain=snj
Quechua,\ Yanahuanca\ Pasco=qur
Siriano=sri
Amba\ (Uganda)=rwm
Karore=xkx
Southern\ Sami=sma
Garus=gyb
Sumau=six
Crimean\ Tatar=crh
French\ (Luxembourg)=fr
Ekit=eke
Popoloca,\ San\ Marcos\ Tlalcoyalco=pls
Alanic=xln
Ayta,\ Ambala=abc
Sekpele=lip
Frisian,\ Northern=frr
Mocoví=moc
Kenga=kyq
Jarawa\ (Nigeria)=jar
Tereweng=twg
Siang=sya
Bumthangkha=kjz
Tehit=kps
Siane=snp
Totonac,\ Ozumatlán=tqt
Uspanteco=usp
Sabaean=xsa
Quechua,\ South\ Bolivian=quh
Semandang=sdm
Biatah=bth
Acheron=acz
Dong,\ Southern=kmc
Ottawa=otw
Singa=sgm
Popoloca,\ San\ Felipe\ Otlaltepec=pow
Lauan=llx
Ngarluma=nrl
English,\ Middle\ (1100-1500)=enm
Stellingwerfs=stl
Tomini=txm
Nahuatl,\ Classical=nci
Kuijau=dkr
Ayta\ (Bataan)=ayt
Kenyah,\ Western=xky
Loncong=lce
English\ (United\ States)=en
Mafea=mkv
Godwari=gdx
Hua=huc
Sa'a=apb
Gaulish,\ Transalpine=xtg
Zapotec,\ Xanaguía=ztg
Kakabai=kqf
Languedocien=lnc
Lamu-Lamu=lby
Una=mtg
Pomo=pmm
Kaimbé=xai
Inabaknon=abx
Malgana=vml
Jita=jit
Macanese=mzs
Abidji=abi
Longto=wok
Tunjung=tjg
Arabic\ (Judeo-Tunisian)=ajt
Mazatec,\ Jalapa\ De\ Díaz=maj
Papitalai=pat
Chin,\ Zotung=czt
Kolami,\ Southeastern=nit
Sanglechi=sgy
Mossi=mos
Tangoa=tgp
Agta,\ Dicamay=duy
Maykulan=mnt
Garre=gex
Chaura=crv
Betaf=bfe
Mambila,\ Nigeria=mzk
Stoney=sto
Uma=ppk
Dutch\ Low\ Saxon=nds-nl
Gagauz=gag
Lelak=llk
Kayan,\ Busang=bfg
Kanauji=bjj
Jiru=jrr
Bukar\ Sadong=sdo
Aramanik=aam
Leti\ (Indonesia)=lti
Wutung=wut
Mixtec,\ Yutanduchi=mab
Mixtec,\ Tezoatlán=mxb
Cham,\ Western=cja
Psikye=kvj
Matukar=mjk
Bemba\ (Democratic\ Republic\ of\ Congo)=bmy
Poke=pof
Pele-Ata=ata
Mentawai=mwv
Hre=hre
Sadri,\ Oraon=sdr
Degexit'an=ing
Fars,\ Southwestern=fay
Itutang=itu
Aghu=ahh
Murkim=rmh
Zapotec,\ Lachixío=zpl
Nahuatl,\ Coatepec=naz
Ganggalida=gcd
Nambya=nmq
Gugu\ Badhun=gdc
Emumu=enr
Tsez=ddo
Helong=heg
Senoufo,\ Nyarafolo=sev
Chané=caj
Gimme=kmp
Betawi=bew
Aekyom=awi
Selangor\ Sign\ Language=kgi
Europanto=eur
Chara=cra
Wotu=wtw
Kami\ (Nigeria)=kmi
Chol,\ Tumbalá=ctu
Manyawa=mny
Laka\ (Nigeria)=lak
Tangko=tkx
Bunaba=bck
Dani,\ Lower\ Grand\ Valley=dni
Tomadino=tdi
Mwera\ (Nyasa)=mjh
Cherepon=cpn
Miwok,\ Coast=csi
Delaware,\ Pidgin=dep
Aimaq=aiq
Veluws=vel
Andaqui=ana
Shambala=ksb
Kosadle=kiq
Karen,\ S'gaw=ksw
Chamalal=cji
Palpa=plp
Changthang=cna
Tavoyan=tvn
Palor=fap
Ngiti=niy
Jina=jia
Alutor=alr
Sasak=sas
Barí=mot
German,\ Hutterite=geh
Baré=bae
Kurux,\ Nepali=kxl
Nooksack=nok
Tuyuca=tue
Madurese=mad
Maria\ (Papua\ New\ Guinea)=mds
Vitou=vto
Mikasuki=mik
Dolpo=dre
Wiraféd=wir
Umpila=ump
Pana\ (Central\ African\ Republic)=pnz
Nyali=nlj
Tsat=huq
Burum-Mindik=bmu
Kanuri,\ Tumari=krt
Kabyle=kab
Kayort=kyv
Iban=iba
Paelignian=pgn
Djambarrpuyngu=djr
Tanggu=tgu
Pomo,\ Eastern=peb
Gulay=gvl
Phana'=phq
Urigina=urg
Batu=btu
Bats=bbl
Iapama=iap
Fang\ (Cameroon)=fak
Kirmanjki\ (individual\ language)=kiu
Angolar=aoa
Tangga=tgg
Itneg,\ Moyadan=ity
Keninjal=knl
Kuna,\ San\ Blas=cuk
Dhivehi=dv
Bata=bta
Angaatiha=agm
Mpade=mpi
Zapotec,\ Coatecas\ Altas=zca
Nusa\ Laut=nul
Sardinian,\ Campidanese=sro
Malay,\ Ambonese=abs
Lingao=onb
Gitonga=toh
Margany=zmc
Romblomanon=rol
Arhuaco=arh
Yangkam=bsx
Tanguat=tbs
Grebo,\ Southern=grj
Udi=udi
Chala=cll
Maltese\ Sign\ Language=mdl
Dusun,\ Central=dtp
Deori=der
Uda=uda
Kwese=kws
Sirmauri=srx
Mwani=wmw
Quichua,\ Cañar\ Highland=qxr
Umbundu=umb
Inoke-Yate=ino
Mindiri=mpn
Macedonian=mk
One,\ Kwamtim=okk
Intha=int
Surubu=sde
Mortlockese=mrl
Mokilese=mkj
Ipili=ipi
Adioukrou=adj
Tetum=tet
English\ (Malta)=en
Sara\ Dunjo=koj
Banggai=bgz
Bari=bfa
Hiw=hiw
Migabac=mpp
Kwere=cwe
Extremaduran=ext
Womo=wmx
Pashayi,\ Northwest=glh
Pitjantjatjara=pjt
Umon=umm
Ipiko=ipo
Irish,\ Middle\ (900-1200)=mga
Marama=lrm
Letzeburgesch=lb
Azerbaijani,\ South=azb
Eritai=ert
Girawa=bbr
Ubi=ubi
Kamba\ (Brazil)=xba
Malecite-Passamaquoddy=pqm
Māhārāṣṭri\ Prākrit=pmh
Camsá=kbh
Judeo-Persian=jpr
Lisela=lcl
Swedish\ (Sweden)=sv
Sandawe=sad
Kayong=kxy
Otomi,\ Tenango=otn
Kulango,\ Bouna=nku
Kadaru=kdu
Groma=gro
Jwira-Pepesa=jwi
Lohar,\ Gade=gda
Dimbong=dii
Hittite,\ Middle=htx
Kadara=kad
Zapotec,\ Santiago\ Lapaguía=ztl
Gugu\ Warra=wrw
Sama,\ Pangutaran=slm
Kuanua=ksd
Oromo,\ Borana-Arsi-Guji=gax
Longgu=lgu
Kaiwá=kgk
Quebec\ Sign\ Language=fcs
Zapotec,\ Quiavicuzas=zpj
Argentine\ Sign\ Language=aed
Skou=skv
Dutch,\ Middle\ (ca.1050-1350)=dum
Idakho-Isukha-Tiriki=ida
Cheyenne=chy
Fa\ d'Ambu=fab
Natügu=ntu
Mbongno=bgu
Mesmes=mys
Teshenawa=twc
Dzongkha=dz
Dâw=kwa
Kumhali=kra
Yagwoia=ygw
Pinigura=pnv
Samatao=ysd
Swati=ss
Pentlatch=ptw
Takelma=tkm
Hittite=hit
Ngile=jle
Quechua,\ North\ Junín=qvn
Ngbandi,\ Northern=ngb
Yogad=yog
Zoque,\ Francisco\ León=zos
Luang=lex
Tebul\ Sign\ Language=tsy
Sulod=srg
Kw'adza=wka
Nyadu=nxj
Croatia\ Sign\ Language=csq
Bana=bcw
Gbe,\ Eastern\ Xwla=gbx
Batanga=bnm
Nigerian\ Sign\ Language=nsi
Jonkor\ Bourmataguil=jeu
Sindang\ Kelingi=sdi
Bamu=bcf
Etulo=utr
Kupia=key
Purum=pub
Marma=rmz
Ainu\ (China)=aib
Machame=jmc
Huitoto,\ Nüpode=hux
Hebrew=iw
Waigeo=wgo
Binahari=bxz
Mbangala=mxg
Mixe,\ Tlahuitoltepec=mxp
Hdi=xed
Simte=smt
Mese=mci
Mbo-Ung=mux
Balo=bqo
Adang=adn
Kambaata=ktb
Naga,\ Wancho=nnp
Kintaq=knq
Dangaléat=daa
Meru=mer
Hawai'i\ Pidgin\ Sign\ Language=hps
Ngbaka\ Ma'bo=nbm
Hulaulá=huy
Baga\ Mboteni=bgm
Kabatei=xkp
Lagwan=kot
Tapieté=tpj
Tepehuan,\ Southwestern=tla
Maninka,\ Sankaran=msc
Jibu=jib
A'tong=aot
Baki=bki
Marka=rkm
Tamahaq,\ Tahaggart=thv
Sarua=swy
Inor=ior
Besoa=bep
Logooli=rag
Kaivi=kce
Jiba=juo
Mixe,\ Coatlán=mco
Gagadu=gbu
Gbaya-Mbodomo=gmm
Holikachuk=hoi
Lunda=lun
Pyapun=pcw
Kuturmi=khj
Drung=duu
Dengka=dnk
Naskapi=nsk
Ghera=ghr
Mulam=mlm
Chut=scb
Okpe\ (Northwestern\ Edo)=okx
Saisiyat=xsy
Kapriman=dju
Saleman=sau
Spanish\ (El\ Salvador)=es
Hinukh=gin
Togoyo=tgy
Sulka=sua
Chug=cvg
Slave\ (Athapascan)=den
Arabic\ (Libya)=ar
Han=haa
Cung=cug
Nahuatl,\ Durango=nln
Hai=hgm
Khunsari=kfm
Te'un=tve
Abipon=axb
Marik=dad
Sarsi=srs
Gokana=gkn
Ganang=gne
Khorezmian=zkh
Ngangam=gng
Giyug=giy
Nukumanu=nuq
Kenyah,\ Kelinyau=xkl
Besme=bes
Male\ (Papua\ New\ Guinea)=mdc
Coxima=kox
Mixtec,\ Atatláhuca=mib
Pomo,\ Central=poo
Woleaian=woe
Old\ Church\ Slavonic=cu
Bunu,\ Jiongnai=pnu
Paiwan=pwn
Karen,\ Manumanaw=kxf
Sangir=sxn
Animere=anf
Sangil=snl
Cia-Cia=cia
Zangskari=zau
Asoa=asv
Min\ Nan=zh-min-nan
Quechua,\ Chachapoyas=quk
Gimi\ (Eastern\ Highlands)=gim
Hindi\ (India)=hi
Yugur,\ East=yuy
Margu=mhg
Jakun=jak
Deccan=dcc
Chin,\ Khumi\ Awa=cka
Kwegu=xwg
Arrarnta,\ Western=are
Kuuku-Ya'u=kuy
Guahibo=guh
Kakanda=kka
Mai\ Brat=ayz
Bathari=bhm
Dakka=dkk
Twi=tw
Latin=la
Arabic,\ Babalia\ Creole=bbz
Safaliba=saf
Tolaki=lbw
Pashto,\ Central=pst
Zamboangueño\ Chavacano=cbk-zam
Komi-Permyak=koi
Cham,\ Eastern=cjm
Liv(onian)=liv
Swahili=sw
Dutch\ (Netherlands)=nl
Chhulung=cur
Avaric=av
Ile\ Ape=ila
Malakote=mlk
Tariano=tae
Leipon=lek
Nyaheun=nev
Fagani=faf
Marfa=mvu
Hibito=hib
Pahlavi=pal
Melo=mfx
Quichua,\ Loja\ Highland=qvj
Nhengatu=yrl
Koneraw=kdw
Italian=it
Toraja-Sa'dan=sda
Korandje=kcy
Walla\ Walla=waa
Senhaja\ De\ Srair=sjs
Asilulu=asl
Tewe=twx
Volapük=vo
Gyem=gye
Jamamadí=jaa
Lungga=lga
Tupinikin=tpk
Hijuk=hij
Kölsch=ksh
Xiri=xii
Chaudangsi=cdn
Kamberau=irx
Lamboya=lmy
Ribun=rir
Dhatki=mki
Taliabu=tlv
Bohtan\ Neo-Aramaic=bhn
Batak\ Alas-Kluet=btz
Nez\ Perce=nez
Ratagnon=btn
Agta,\ Central\ Cagayan=agt
Bade=bde
Chamicuro=ccc
Arikapú=ark
Ngelima=agh
Nijadali=nad
Juray=juy
Gabrielino-Fernandeño=xgf
Runga=rou
Kannada=kn
Chuave=cjv
Tso=ldp
Varisi=vrs
Mak\ (Nigeria)=pbl
Tuotomb=ttf
Turiwára=twt
Tajuasohn=tja
Oorlams=oor
Kreen-Akarore=kre
Sanga\ (Nigeria)=xsn
Trió=tri
Laimbue=lmx
Guana\ (Paraguay)=gva
Mixtec,\ Metlatónoc=mxv
Mom\ Jango=ver
Inga=inb
Wom\ (Papua\ New\ Guinea)=wmo
Malay,\ Bukit=bvu
Eravallan=era
Sarli=sdf
Italian\ Sign\ Language=ise
Kanamarí=knm
Sawila=swt
Mazatec,\ Mazatlán=vmz
Russian,\ Old=orv
Gros\ Ventre=ats
Marba=mpg
Biwat=bwm
Bullom\ So=buy
Batak\ Simalungun=bts
Baba=bbw
Koroshi=ktl
Andegerebinha=adg
Aizi,\ Tiagbamrin=ahi
Marau=mvr
Teso=teo
Andoque=ano
Patani=ptn
Pa\ Di=pdi
Nzakara=nzk
Prasuni=prn
Tese=keg
Ashe=ahs
Baan=bvj
Romansh=rm
Purik=prx
Aklanon=akl
Hmong,\ Southern\ Mashan=hma
Arikara=ari
Sileibi=sbq
Rundi=rn
Saluan,\ Coastal=loe
Nukuria=nur
Bolgarian=xbo
Choctaw=cho
Gwi=gwj
Romani,\ Sinte=rmo
Ogea=eri
Cuicatec,\ Tepeuxila=cux
Naga,\ Sumi=nsm
Gwa=gwb
Kaiku=kkq
Tera=ttr
Adabe=adb
Beothuk=bue
Dai\ Zhuang=zhd
Sinhala=si
Olrat=olr
Kofyar=kwl
Kami\ (Tanzania)=kcu
Kulere=kul
Kaike=kzq
Tombonuwo=txa
Motlav=mlv
Laghu=lgb
Haida,\ Northern=hdn
Kumarbhag\ Paharia=kmj
Aukan=djk
Afitti=aft
Pame,\ Southern=pmz
Tol=jic
Mak\ (China)=mkg
Kpan=kpk
Seimat=ssg
Arabic\ (Judeo-Moroccan)=aju
Wunambal=wub
Tausug=tsg
Tlapanec,\ Acatepec=tpx
Karawa=xrw
Jalkunan=bxl
Migaama=mmy
Mixe,\ North\ Central=neq
Gun=guw
Seke\ (Vanuatu)=ske
Greek\ (Cyprus)=el
Rufiji=rui
Gua=gwx
Gondi,\ Southern=ggo
Bajelani=bjm
Naga,\ Thangal=nki
Merwari=wry
Aja\ (Sudan)=aja
O'du=tyh
Côông=cnc
Quechua,\ Huallaga\ Huánuco=qub
Bada\ (Nigeria)=bau
Teor=tev
Teop=tio
Taman\ (Myanmar)=tcl
Izere=izr
Nkem-Nkum=isi
Tapei=afp
Wejewa=wew
Dororo=drr
Lambya=lai
Landoma=ldm
Dyula=dyu
Maleu-Kilenge=mgl
Tzeltal,\ Oxchuc=tzh
Nhanda=nha
Rapanui=rap
Ná-Meo=neo
Waneci=wne
Doso=dol
Baka\ (Cameroon)=bkc
Dazaga=dzg
Lumun=lmd
Pasi=psq
Bidyogo=bjg
Kapingamarangi=kpg
Ogan=ogn
Zapotec,\ Santa\ Catarina\ Albarradas=ztn
Palu'e=ple
Minigir=vmg
Tangchangya=tnv
Onondaga=ono
Oriya,\ Desiya=dso
Lotud=dtr
Ikpeng=txi
Alune=alp
Mobilian=mod
Khisa=kqm
Maninka,\ Konyanka=mku
Ke'o=xxk
Al-Sayyid\ Bedouin\ Sign\ Language=syy
Chin,\ Mara=mrh
Qabiao=laq
Aimele=ail
Mbangi=mgn
Tikar=tik
Lafofa=laf
Isinai=inn
Ngura=nbx
Mono\ (Cameroon)=mru
Kakihum=kxe
Karata=kpt
Solano=xso
Pare=ppt
Khetrani=xhe
Punan\ Merap=puc
Iamalele=yml
Swahili,\ Congo=swc
Undetermined=und
Punan\ Merah=puf
Bolivian\ Sign\ Language=bvl
Temi=soz
Nyamusa-Molo=nwm
Lorediakarkar=lnn
Pomo,\ Northeastern=pef
Teme=tdo
Karen,\ Zayein=kxk
Maragus=mrs
Uvbie=evh
Miriti=mmv
Popoloca,\ San\ Luís\ Temalacayuca=pps
Northern\ Bontok=rbk
Mandarin\ Chinese=cmn
Kaluli=bco
Swiss\ German=gsw
Asas=asd
Simbo=sbb
Itelmen=itl
Denya=anv
Kohoroxitari=kob
Kosena=kze
Popoloca,\ San\ Juan\ Atzingo=poe
Nyeu=nyl
Kemak=kem
Swedish=sv
Macedo\ Romanian=roa-rup
Tehuelche=teh
Atorada=aox
Tedaga=tuq
Simba=sbw
Karankawa=zkk
Ipulo=ass
Ulwa=ulw
Asu\ (Tanzania)=asa
Kaiep=kbw
Galician=gl
Papi=ppe
Wuliwuli=wlu
Natanzi=ntz
Hun-Saare=dud
Ashkun=ask
Achí,\ Rabinal=acr
Chuwabu=chw
Jaunsari=jns
Ndemli=nml
Ngombe\ (Democratic\ Republic\ of\ Congo)=ngc
Tiv=tiv
Marúbo=mzr
Ewage-Notu=nou
Gadjerawang=gdh
Simaa=sie
Kaxuiâna=kbb
Yalahatan=jal
Tii=txq
Opuuo=lgn
Munsee=umu
Kuku-Ugbanh=ugb
Jakati=jat
Gwahatike=dah
Lintang=lnt
Cutchi-Swahili=ccl
Estonian=et
Mattole=mvb
Gor=gqr
Eipomek=eip
Czech=cs
Doromu=kqc
Awyu\ (Central)=awu
Isebe=igo
Bali\ (Nigeria)=bcn
Miluk=iml
Geser-Gorom=ges
Martu\ Wangka=mpj
Tetun\ Dili=tdt
Javindo=jvd
Laka\ (Chad)=lap
Tamazight,\ Central\ Atlas=tzm
Tho=tou
Zapotec,\ Yatzachi=zav
Wayu=vay
Shamang=xsh
Arabic\ (Yemen)=ar
Punan\ Batu\ 1=pnm
Koyo=koh
Teluti=tlt
The=thx
Ukpe-Bayobiri=ukp
Tha=thy
Norse,\ Old=non
Interglossa=igs
Miltu=mlj
Sauraseni\ Prākrit=psu
Kulon-Pazeh=uun
Dong=doh
Bargam=mlp
Gupa-Abawa=gpa
Koya=kff
Manipa=mqp
Krevinian=zkv
Sogdian=sog
Sewa\ Bay=sew
Lakalei=lka
Domu=dof
Apalachee=xap
Kalinga,\ Mabaka\ Valley=kkg
Kanakanabu=xnb
Taznatit=grr
La'bi=lbi
Jofotek-Bromnya=jbr
Chin,\ Tawr=tcp
Lishanid\ Noshan=aij
Ngulu=ngp
Giangan=bgi
Bintulu=bny
Nyaw=nyw
Palu=pbz
Uhami=uha
Karo\ (Ethiopia)=kxh
Dawro=dwr
Koongo=kng
Nyam=nmi
Citak,\ Tamnim=tml
Alugu=aub
Karang=kzr
Mbugwe=mgz
Karajá=kpj
Yugur,\ West=ybe
Chak=ckh
Manipuri=mni
Kaian=kct
Iaai=iai
Bena\ (Tanzania)=bez
Pali=pi
Nagumi=ngv
Asuri=asr
Wawa=www
Gaelic\ (Scots)=gd
Ikwere=ikw
Sukur=syk
Kala\ Lagaw\ Ya=mwp
Gorap=goq
Moere=mvq
Mpiemo=mcx
Paku=pku
Ban\ Khor\ Sign\ Language=bfk
Valpei=vlp
Tem=kdh
Nyungwe=nyu
Karami=xar
Njebi=nzb
Mam,\ Todos\ Santos\ Cuchumatán=mvj
Majera=xmj
Uamué=uam
Wára=tci
Kakabe=kke
Tee=tkq
Omurano=omu
Wichí\ Lhamtés\ Nocten=mtp
Xibe=sjo
Kove=kvc
Cheke\ Holo=mrn
Maba\ (Indonesia)=mqa
Doka=dbi
Marathi=mr
Guanano=gvc
Gurani=hac
Cebuano=ceb
Polci=plj
Kipsigis=sgc
Nzanyi=nja
Mapidian=mpw
Savara=svr
Cakchiquel,\ Yepocapa\ Southwestern=cbm
Namibian\ Sign\ Language=nbs
Asturian=ast
Egyptian=egy
Kiput=kyi
Afar=aa
Leelau=ldk
Ambele=ael
Páez=pbb
Waruna=wrv
Saamia=lsm
Mambai=mcs
Mambae=mgm
So\ (Cameroon)=sox
Yi,\ Poluo\ (Pholo)=yip
Giryama=nyf
Sara\ Kaba=sbz
Phong-Kniang=pnx
Comox=coo
Aymara,\ Southern=ayc
Ranglong=rnl
Lonwolwol=crc
Aruá=arx
Kott=zko
Sedang=sed
Lasgerdi=lsa
Araki=akr
Warlmanpa=wrl
Koti=eko
Portuguese=pt
Auyokawa=auo
Adynyamathanha=adt
Jinuo,\ Youle=jiu
Sheni=scv
Welsh,\ Old=owl
Minriq=mnq
Izon=ijc
Lusengo=lse
Gbe,\ Waci=wci
Wasu=wsu
Miwok,\ Central\ Sierra=csm
Kowiai=kwh
El\ Hugeirat=elh
Quechua,\ Pacaraos=qvp
Arabic\ (Uzbeki)=auz
Pahi=lgt
Comorian,\ Ngazidja=zdj
Pnar=pbv
Akoose=bss
Barzani\ Jewish\ Neo-Aramaic=bjf
Dieri=dif
Wasa=wss
Mysian=yms
Kayapó=txu
Quenya=qya
Awyu\ (Jair)=awv
Embaloh=emb
Pagu=pgu
Waru=wru
Kunbarlang=wlg
Karaim=kdr
Tal=tal
Pisidian=xps
Triqui,\ San\ Martín\ Itunyoso=trq
Kurtokha=xkz
Spanish\ (Paraguay)=es
Tai=taw
Berti=byt
Ashtiani=atn
Mehri=gdq
Wané=hwa
Pagi=pgi
Berta=wti
Wahgi,\ North=whg
Ware=wre
Thachanadan=thn
Konongo=kcz
Wara=wbf
Nunggubuyu=nuy
Huitoto,\ Murui=huu
Pahari-Potwari=phr
Kango\ (Bas-Uélé\ District)=kty
Doga=dgg
Kerewo=kxz
Kâte=kmg
Vishavan=vis
Logol=lof
Kerewe=ked
Sanga\ (Democratic\ Republic\ of\ Congo)=sng
Mawa\ (Nigeria)=wma
Ikizu=ikz
Ambrak=aag
Karnai=bbv
Yimas=yee
Sheko=she
Parkwa=pbi
Pahanan\ Agta=apf
Likila=lie
Dirim=dir
Ap\ Ma=kbx
Selian=sxl
Kamoro=kgq
Dinka,\ Northwestern=diw
Áncá=acb
Tembo\ (Kitembo)=tbt
Arua=aru
Bhatri=bgw
Bauchi=bsf
Gey=guv
Caluyanun=clu
Ambelau=amv
Maidu,\ Valley=vmv
Sentani=set
Emberá,\ Northern=emp
Tandaganon=tgn
Gen=gej
Chadian\ Sign\ Language=cds
Sakechep=sch
Yarawata=yrw
Fuyug=fuy
Zapotec,\ Sierra\ de\ Juárez=zaa
Indonesian,\ Peranakan=pea
Haiphong\ Sign\ Language=haf
Kaure=bpp
Slovak\ (Slovakia)=sk
Inari\ Sami=smn
Bokoto=bdt
Arta=atz
Chenapian=cjn
Pahari,\ Kullu=kfx
Ikpeshi=ikp
Vlax\ Romani=rmy
Yapese=yap
Luba-Lulua=lua
Mandahuaca=mht
Waima=rro
Ede\ Nago=nqg
Ngombale=nla
Southern\ Pesisir=pec
Romanova=rmv
Luvale=lue
Spanish\ (United\ States)=es
Arabic\ (Tajiki)=abh
Uvean,\ West=uve
Guhu-Samane=ghs
Hmong,\ Luopohe=hml
Kupsabiny=kpz
Wano=wno
Sampang=rav
Gangulu=gnl
Lepcha=lep
Wik-Epa=wie
Xiriâna=xir
Ogbogolo=ogg
Chontal,\ Highland\ Oaxaca=chd
Malay,\ Jambi=jax
Sizaki=szk
Youjiang\ Zhuang=zyj
Khaling=klr
Nyiha\ (Malawi)=nyr
Tugen,\ North=tuy
Berom=bom
Dobu=dob
Kucong=lkc
Guaraní,\ Paraguayan=gug
Mixtec,\ Apasco-Apoala=mip
Sehwi=sfw
Malagasy,\ Southern\ Betsimisaraka=bjq
Seko\ Padang=skx
Wakawaka=wkw
Komi=kv
Kwesten=kwt
Chin,\ Ngawn=cnw
Catawba=chc
Koma=kmy
Anjam=boj
Telugu=te
Acroá=acs
Macushi=mbc
Souletin\ Basque=bsz
Maraghei=vmh
Watut,\ Middle=mpl
Mari,\ Eastern=mhr
Pangwa=pbr
Papuan\ Malay=pmy
Dutch\ (Belgium)=nl
Tsonga=ts
Quiché,\ Eastern=quu
German\ (Switzerland)=de
Gowlan=goj
Karelian=krl
Gao=gga
Bujhyal=byh
Gan=gan
Wala=lgl
Spanish\ (Ecuador)=es
Gal=gap
Kola=kvv
Kahua=agw
Buhid=bku
O'chi'chi'=xoc
Bobot=bty
Trinidadian\ Creole\ English=trf
Karen,\ Paku=kpp
Gaa=ttb
Sapuan=spu
Lumbu=lup
Quechua,\ Ayacucho=quy
Anmatyerre=amx
Ashéninka,\ Ucayali-Yurúa=cpb
Bouyei=pcc
Gudanji=nji
Malagasy,\ Northern\ Betsimisaraka=bmm
Tok\ Pisin=tpi
Mandaya,\ Sangab=myt
Danish\ (Denmark)=da
Koke=kou
Waka=wav
Sami,\ Kemi=sjk
Kelon=kyo
Yawalapití=yaw
Guyani=gvy
Phudagi=phd
Nokuku=nkk
Magar,\ Eastern=mgp
Matbat=xmt
Yongnan\ Zhuang=zyn
Ugaritic=uga
Nahuatl,\ Central=nhn
Tzotzil,\ Chenalhó=tze
Ewondo=ewo
Sikiana=sik
Mudbura=mwd
Kenati=gat
Waja=wja
Tunebo,\ Angosturas=tnd
Gaddi=gbk
Ringgou=rgu
Dijim-Bwilim=cfa
Lengilu=lgi
Numbami=sij
Ngamambo=nbv
Yaka\ (Congo)=iyx
Aramaic,\ Talmudic=tmr
Sekani=sek
Kreye=xre
South\ African\ Sign\ Language=sfs
Yukaghir,\ Northern=ykg
Wampanoag=wam
Karekare=kai
Low\ Saxon=nds
Malgbe=mxf
Kota\ (Gabon)=koq
Dogon,\ Tene\ Kan=dtk
Talinga-Bwisi=tlj
Ayta,\ Mag-Anchi=sgb
Arma=aoh
Vlaams=vls
Koho=kpm
Kashmiri=ks
Puyuma=pyu
Niuean=niu
Arhö=aok
Harsusi=hss
Lashi=lsi
Nahuatl,\ Northern\ Puebla=ncj
Fanagalo=fng
Mixtec,\ Southwestern\ Tlaxiaco=meh
Mamasa=mqj
Ngatik\ Men's\ Creole=ngm
Tairuma=uar
Sur=tdl
Bangwinji=bsj
Kirundi=rn
Bura-Pabir=bwr
Kovai=kqb
Iwam,\ Sepik=iws
Ulch=ulc
Arhâ=aqr
Naga,\ Moyon=nmo
Berik=bkl
Sui=swi
Tukumanféd=tkf
Zapotec,\ Zaachila=ztx
Lojban=jbo
Wagi=fad
Yukpa=yup
Mbonga=xmb
Gwamhi-Wuri=bga
Arabic\ (Chadian)=shu
Lindu=klw
Mele-Fila=mxe
Hungarian\ Sign\ Language=hsh
Hoia\ Hoia=hhi
Kudiya=kfg
Amahuaca=amc
Yoron=yox
Geruma=gea
Paranan=prf
Tombelala=ttp
Chin,\ Bualkhaw=cbl
Wandji=wdd
Citak=txt
Ixil,\ Chajul=ixj
Enwan\ (Akwa\ Ibom\ State)=enw
Quinault=qun
Garhwali=gbm
Karirí-Xocó=kzw
Rangkas=rgk
Yagaria=ygr
Adangme=ada
Kofa=kso
Albanian\ (Arbëreshë\ Dialect)=aae
Manusela=wha
Uneapa=bbn
Cocama-Cocamilla=cod
Low\ German=nds
Kaili,\ Da'a=kzf
Kanum,\ Sota=krz
Blaan,\ Koronadal=bpr
Sempan=xse
Northern\ Sotho=nso
Zapotec,\ Tejalapan=ztt
Japanese,\ Old=ojp
Tsotsitaal=fly
Tutuba=tmi
Mehek=nux
Bakhtiari=bqi
Tocho=taz
Even=eve
Morigi=mdb
Ihievbe=ihi
Nedebang=nec
Moroccan\ Sign\ Language=xms
Arabic,\ Gulf\ Spoken=afb
Tacana=tna
Bandial=bqj
Tumtum=tbr
Sarikoli=srh
Arin=xrn
Bekwil=bkw
Kho'ini=xkc
Kaidipang=kzp
Kayabí=kyz
Khanty=kca
Yalunka=yal
Jiamao=jio
Roon=rnn
Ugandan\ Sign\ Language=ugn
Danaru=dnr
Vunapu=vnp
Camtho=cmt
Logba=lgq
Nawathinehena=nwa
Kodi=kod
Naga,\ Monsang=nmh
Koda=cdz
Sadri=sck
Chichimeca-Jonaz=pei
Kairui-Midiki=krd
Beele=bxq
Keapara=khz
Todrah=tdr
Yaqui=yaq
Luba-Katanga=lu
Muyu,\ South=kts
Rajong=rjg
Zhuang=za
Nahuatl\ languages=nah
Karahawyana=xkh
Heyo=auk
Katcha-Kadugli-Miri=xtc
Wyandot=wya
Bidyara=bym
Koch=kdq
Dirari=dit
Kaikadi=kep
Aghwan=xag
Agariya=agi
Sami,\ Kildin=sjd
Burushaski=bsk
Jirel=jul
Quechua,\ Yauyos=qux
Beeke=bkf
Fwe=fwe
Mixtec\ (Western\ Juxtlahuaca)=jmx
Mbo\ (Cameroon)=mbo
Mono\ (USA)=mnr
Popoloca,\ Mezontla=pbe
Karaboro,\ Western=kza
Wabo=wbb
Weyto=woy
Bahing=bhj
Wè\ Northern=wob
Central\ Malay=pse
Arabic\ (Sanaani)=ayn
Ingush=inh
Makhuwa=vmw
Yucuna=ycn
Siar-Lak=sjr
Emplawas=emw
Central\ Bontok=lbk
Koba=kpd
Roma=rmm
Sou=sqq
Quechua,\ Napo\ Lowland=qvo
Lisu=lis
Watubela=wah
Sop=urw
Soo=teu
Som=smc
Sok=skk
Burunge=bds
Kunza=kuz
Soi=soj
Maiadomu=mzz
Lish=lsh
Nangikurrunggurr=nam
Xipaya=xiy
Atong=ato
Fur=fvr
Maden=xmx
Bhaya=bhe
Bangi=bni
Sénoufo,\ Sìcìté=sep
Fum=fum
Balkan\ Gagauz\ Turkish=bgx
Arem=aem
Bomboma=bws
Kunyi=njx
Maltese=mt
Hewa=ham
Tai\ Loi=tlq
Kanite=kmu
Zoque,\ Copainalá=zoc
Suba-Simbiti=ssc
Kouya=kyf
Bavarian=bar
Kabwari=kcw
Quiché,\ Central=quc
Dehwari=deh
French=fr
Pááfang=pfa
Kallahan,\ Kayapa=kak
Putukwam=afe
Dugwor=dme
Waritai=wbe
Numidian=nxm
Comorian=swb
Bomboli=bml
Tabla=tnm
C'lela=dri
Haitian=ht
Aeka=aez
Levuka=lvu
Andalusian\ Arabic=xaa
Arabic\ (United\ Arab\ Emirates)=ar
Qatabanian=xqt
Urhobo=urh
Karolanos=kyn
Waurá=wau
Orang\ Seletar=ors
Cahuilla=chl
Sardinian,\ Logudorese=src
Talondo'=tln
Nabak=naf
Daza=dzd
Mambila,\ Cameroon=mcu
Maklew=mgf
Huambisa=hub
Khotanese=kho
Kuku-Yalanji=gvn
Irish=ga
Kurdish,\ Southern=sdh
Mandeali=mjl
Lipo=lpo
Katukína,\ Panoan=knt
Dayi=dax
Bada\ (Indonesia)=bhz
Marimanindji=zmm
Orya=ury
Crioulo,\ Upper\ Guinea=pov
Pakaásnovos=pav
Ghomálá'=bbj
Thudam=thw
Borong=ksr
Ijo,\ Southeast=ijs
Kaningi=kzo
Bandi=bza
Amuzgo\ (Ipalapa)=azm
Tagbanwa=tbw
Xaragure=axx
Piapoco=pio
Mampruli=maw
Tsamai=tsb
Gula\ Iro=glj
Divehi=dv
Zapotec,\ San\ Agustín\ Mixtepec=ztm
Tanema=tnx
Mefele=mfj
Ludian=lud
Nipsan=nps
Kituba\ (Congo)=mkw
Cimbrian=cim
Godié=god
Mayan,\ Epigraphic=emy
Madak=mmx
Wè\ Western=wec
Tsimané=cas
Nottoway-Meherrin=nwy
Kanashi=xns
Noone=nhu
Nocamán=nom
Mam,\ Northern=mam
Wanambre=wnb
Asumboa=aua
Herdé=hed
Glavda=glw
Dinka,\ Northeastern=dip
Ukwa=ukq
Rogo=rod
Laghuu=lgh
Carrier,\ Southern=caf
Narungga=nnr
Tontemboan=tnt
Manikion=mnx
Khvarshi=khv
Chilean\ Sign\ Language=csg
Dogon,\ Yanda\ Dom=dym
Yora=mts
Katbol=tmb
Sakirabiá=skf
Tukudede=tkd
Mauritian\ Sign\ Language=lsy
Bon\ Gula=glc
Sio=xsi
Kamviri=xvi
Toussian,\ Northern=tsp
Culina=cul
Chinantec,\ Tepinapa=cte
Gbaya,\ Northwest=gya
Sie=erg
Gikyode=acd
Wasco-Wishram=wac
Portuguese\ (Portugal)=pt
Yi,\ Southeastern\ Lolo\ (Nisi)=yso
Yarsun=yrs
Galatian=xga
Inapang=mzu
Fon=fon
Adangbe=adq
Daur=dta
Degema=deg
Foi=foi
Siwu=akp
Mandaic,\ Classical=myz
Tuvinian=tyv
Swiss-German\ Sign\ Language=sgg
Ukue=uku
Pa-Hng=pha
Oriya=or
Welsh=cy
Shi=shr
Lele\ (Democratic\ Republic\ of\ Congo)=lel
Siwi=siz
She=shx
Hmong,\ Northeastern\ Dian=hmd
Sha=scw
Bareli,\ Palya=bpx
Malasar=ymr
Mandaya,\ Karaga=mry
Mehináku=mmh
Limilngan=lmc
Nanti=cox
Nivkh=niv
Panchpargania=tdb
Babar,\ North=bcd
Welsh,\ Middle=wlm
Yagomi=ygm
Luyia=luy
Shall-Zwall=sha
Tinani=lbf
Liki=lio
German\ (Austria)=de
Zapotec,\ San\ Vicente\ Coatlán=zpt
Achterhooks=act
Tuma-Irumu=iou
Pilagá=plg
Bwisi=bwz
Lika=lik
Bugun=bgg
Vepsian=vep
Dass=dot
Odiai=bhf
Pathiya=pty
Muduga=udg
Mapun=sjm
Ambai=amk
Mpur=akc
Portuguese\ (Brazil)=pt
English\ (New\ Zealand)=en
Spanish\ (Spain)=es
Jowulu=jow
Heiltsuk=hei
Yong=yno
Demta=dmy
Kikuyu=ki
Mabaale=mmz
Khuen=khf
Guaraní,\ Western\ Bolivian=gnw
Kilmeri=kih
Kiowa=kio
Arigidi=aqg
Kujarge=vkj
CHARu=cje
Ngad'a=nxg
Warduji=wrd
Mbara\ (Australia)=mvl
Iduna=viv
Mukha-Dora=mmk
Haitian\ Creole=ht
Tooro=ttj
Sudest=tgo
Western\ Panjabi=pnb
Bodo\ Parja=bdv
Kirike=okr
Hema=nix
Hanga=hag
Dhalandji=dhl
Iyive=uiv
Kuranko=knk
Kui\ (India)=kxu
Wik-Keyangan=wif
Kendayan=knx
Mbedam=xmd
Chhintange=ctn
Pwaamei=pme
Pengo=peg
Polari=pld
Igede=ige
Koro\ (Côte\ d'Ivoire)=kfo
Kalinga,\ Limos=kmk
Ma\ (Papua\ New\ Guinea)=mjn
Yabaâna=ybn
Balinese=ban
Standard\ Latvian=lvs
Wom\ (Nigeria)=wom
Tasmate=tmt
Komo\ (Democratic\ Republic\ of\ Congo)=kmw
Jiarong=jya
Austrian\ Sign\ Language=asq
Yola=yol
Giziga,\ South=giz
Byep=mkk
Dusun\ Deyah=dun
Mbariman-Gudhinma=zmv
Cherokee=chr
Udihe=ude
Kutenai=kut
Mixtec,\ Diuxi-Tilantongo=xtd
Boselewa=bwf
Siri=sir
Mabire=muj
Sherdukpen=sdp
Doyayo=dow
Sira=swj
Drents=drt
Fulah=ff
Tremembé=tme
Mari,\ Western=mrj
Yi,\ Mili=ymh
Uzbek,\ Southern=uzs
Yoke=yki
Lamang=hia
Ta'oih,\ Upper=tth
Fongoro=fgr
Ura\ (Papua\ New\ Guinea)=uro
Orok=oaa
Totonac,\ Xicotepec\ De\ Juárez=too
Riang\ (India)=ria
Qiang,\ Northern=cng
Djeebbana=djj
Awyu,\ North=yir
Romagnol=rgn
Ambae,\ East=omb
Atikamekw=atj
Nyindrou=lid
Ilue=ilv
Sar=mwm
Dano=aso
Kono\ (Nigeria)=klk
Japanese=ja
Tanjong=tnj
Kilivila=kij
Sam=snx
Katua=kta
Kunfal=xuf
Kiorr=xko
Kudu-Camo=kov
Mukulu=moz
Wageman=waq
Magar,\ Western=mrd
Ormu=orz
Micmac=mic
Rembarunga=rmb
Xaasongaxango=kao
Potiguára=pog
Pongyong=pgy
Slovenian=sl
Maquiritari=mch
Orma=orc
Dama=dmm
Badimaya=bia
Latvian\ (Latvia)=lv
Dumpas=dmv
Lantanai=lni
Mala\ (Nigeria)=ruy
Serudung\ Murut=srk
Koro\ (Vanuatu)=krf
Popoluca,\ Highland=poi
Lwalu=lwa
Bwile=bwc
Ifugao,\ Amganad=ifa
Kaniet=ktk
Bikaru=bic
Katso=kaf
Kamayo=kyk
Hovongan=hov
Zapotec,\ Yareni=zae
Okiek=oki
Bamwe=bmg
Hebrew,\ Ancient=hbo
Hehe=heh
Cakchiquel,\ Acatenango\ Southwestern=ckk
Teressa=tef
Wanggamala=wnm
Mixtec,\ Tijaltepec=xtl
Oko-Eni-Osayen=oks
Sinsauru=snz
Wuzlam=udl
Telefol=tlf
Kawi=kaw
Kunja=pep
Islander\ Creole\ English=icr
Maya,\ Chan\ Santa\ Cruz=yus
Kawe=kgb
Mwatebu=mwa
Ngiemboon=nnh
Koalib=kib
Nepali=ne
Xinca=xin
Albanian\ (Tosk)=als
Muyu,\ North=kti
East\ Cree\ (Southern)=crj
Mari\ (Madang\ Province)=hob
Harari=har
Chulym=clw
German,\ Old\ High\ (ca.750-1050)=goh
Idu-Mishmi=clk
Banawá=bnh
Tiwa,\ Southern=tix
Naga,\ Tase=nst
Bamun=bax
Viemo=vig
Bhadrawahi=bhd
Tenino=tqn
Yaqay=jaq
Matlatzinca,\ San\ Francisco=mat
Wikngenchera=wua
Churahi=cdj
Kaur=vkk
Urapmin=urm
Oring=org
Malinguat=sic
Teke-Ebo=ebo
Önge=oon
Makhuwa-Meetto=mgh
Sila=slt
Knaanic=czk
Zapotec,\ Guevea\ De\ Humboldt=zpg
Ukit=umi
Kiong=kkm
Karakalpak=kaa
Cotoname=xcn
Punan\ Aput=pud
Tikopia=tkp
Nanga\ Dama\ Dogon=nzz
Dair=drb
Bonkiman=bop
Attapady\ Kurumba=pkr
Walungge=ola
Kato=ktw
Shendu=shl
Pashto,\ Southern=pbt
Likuba=kxx
Kati=bsh
Karaboro,\ Eastern=xrb
Tay\ Khang=tnu
Arabana=ard
Chinantec,\ Lalana=cnl
Wa'ema=wag
Sika=ski
Bonjo=bok
Haveke=hvk
Zapotec,\ Quioquitani-Quierí=ztq
Greek,\ Mycenaean=gmy
Dixon\ Reef=dix
Malaynon=mlz
Aghul=agx
Mixtec,\ Cuyamecalco=xtu
Luwo=lwo
Kara\ (Papua\ New\ Guinea)=leu
Wojenaka=jod
Tamang,\ Eastern=taj
Fas=fqs
Koli,\ Kachi=gjk
Aguna=aug
Buru\ (Indonesia)=mhs
Sursurunga=sgz
Fam=fam
Cree\ (Plains)=crk
Blissymbols=zbl
Rajasthani=raj
Hazaragi=haz
Kari=kbj
Tamazight,\ Temacine=tjo
Papuma=ppm
Minokok=mqq
Kunigami=xug
Vengo=bav
Mapia=mpy
Gula\ (Chad)=glu
Daga=dgz
Kioko=ues
Huachipaeri=hug
Newari=new
Eñepa=pbh
Murupi=mqw
Yoba=yob
Harami=xha
Kagulu=kki
Lambadi=lmn
Arabic\ (Saudi\ Arabia)=ar
Piamatsina=ptr
Kunda=kdn
Kamasa=klp
Kplang=kph
Apache\ (Kiowa)=apk
Nyabwa=nwb
Bongu=bpu
Mixe,\ Isthmus=mir
Malaccan\ Creole\ Malay=ccm
Coahuilteco=xcw
Svan=sva
Tefaro=tfo
Trinidad\ and\ Tobago\ Sign\ Language=lst
Roglai,\ Northern=rog
Bongo=bot
Kamaru=kgx
Nggem=nbq
Lango\ (Uganda)=laj
Gumatj=gnn
Pokomchí,\ Eastern=poh
Larike-Wakasihu=alo
Ikulu=ikl
Hmong,\ Eastern\ Huishui=hme
Awyu,\ Asue=psa
Diodio=ddi
Gurung,\ Eastern=ggn
Quiché,\ Joyabaj=quj
Kundal\ Shahi=shd
Katla=kcr
Min\ Dong\ Chinese=cdo
Kamara=jmr
Moloko=mlw
Piscataway=psy
Amara=aie
Ossetian=os
Majhwar=mmj
Fortsenal=frt
Zire=sih
Kohin=kkx
Rwa=rwk
Mazanderani=mzn
Khirwar=kwx
Kachama-Ganjule=kcx
Zapotec,\ Southern\ Rincon=zsr
Wahgi=wgi
Lyons\ Sign\ Language=lsg
Azerbaijani=az
Italian\ (Switzerland)=it
Nandi=niq
Kallahan,\ Tinoc=tne
Walloon=wa
Nande=nnb
Sorothaptic=sxo
Adamorobe\ Sign\ Language=ads
Jinuo,\ Buyuan=jiy
Ojibwa=oj
Yangum\ Mon=ymo
Yi,\ Dongshanba\ Lalo=yik
Terik=tec
Etchemin=etc
Mundurukú=myu
Chicomuceltec=cob
Lusi=khl
Termanu=twu
Dungmali=raa
Mixtec,\ Tacahua=xtt
Hoava=hoa
Kanu=khx
Venda=ve
Tiéfo=tiq
Massep=mvs
Kallahan,\ Keley-I=ify
Kang=kyp
Moikodi=mkp
Bondo=bfw
Luri=ldd
Mixtec,\ Tidaá=mtx
Anuta=aud
Suyá=suy
Kamu=xmu
Finongan=fag
Malay,\ Cocos\ Islands=coa
Kamo=kcq
Salvadoran\ Sign\ Language=esn
Banaro=byz
Afade=aal
Molbog=pwm
Kuanyama=kj
Dibiyaso=dby
Fe'fe'=fmp
Dabe=dbe
Kaskean=zsk
Daba=dbq
Naga,\ Maring=nng
Mixe,\ Juquila=mxq
Meramera=mxm
Kathu=ykt
Provençal,\ Old\ (to\ 1500)=pro
Boro\ (Ghana)=xxb
Mpuono=zmp
Tlapanec,\ Tlacoapa=tpl
Shahmirzadi=srz
Nanai=gld
Kamano=kbq
Meta'=mgo
Ho\ Chi\ Minh\ City\ Sign\ Language=hos
Kok\ Borok=trp
Kamang=woi
Rawo=rwa
Mundari=unr
Zoque,\ Chimalapa=zoh
Esperanto=eo
Hoyahoya=hhy
Otomi,\ Temoaya=ott
Marwari=mwr
Kanuri=kr
Purisimeño=puy
Panjabi,\ Western=pnb
Rawa=rwo
Uru-Eu-Wau-Wau=urz
Ligurian=lij
Ocaina=oca
Angal\ Enen=aoe
Malay,\ Kota\ Bangun\ Kutai=mqg
Aneityum=aty
Burmeso=bzu
Nauruan=na
Fernando\ Po\ Creole\ English=fpe
Sibu=sdx
Limbu=lif
Chin,\ Haka=cnh
Burumakok=aip
Kako=kkj
Karen,\ Pwo\ Northern=pww
Burmese=my
Baga\ Binari=bcg
Pisabo=pig
Mixifore=mfg
Yuwana=yau
Tamajaq,\ Tawallammat=ttq
Pogolo=poy
Terei=buo
Kenyang=ken
Banda-Yangere=yaj
Sibe=nco
Biritai=bqq
Bugan=bbh
Bonan=peh
Inupiatun,\ Northwest\ Alaska=esk
Khamti=kht
Urimo=urx
Aoheng=pni
Agta,\ Camarines\ Norte=abd
Mantsi=nty
Filipino=fil
Central\ Hongshuihe\ Zhuang=zch
Nahari=nhh
Sian=spg
Uripiv-Wala-Rano-Atchin=upv
Me'en=mym
Avikam=avi
Lamogai=lmg
Bafaw-Balong=bwt
Kabiyé=kbp
Kaiy=tcq
Kais=kzm
Luna=luj
Bazigar=bfr
Anakalangu=akg
Bemba\ (Zambia)=bem
Ewe=ee
Wilawila=wil
Buginese=bug
Thompson=thp
Lango\ (Sudan)=lno
Inonhan=loc
Gumalu=gmu
Giziga,\ North=gis
Kabixí=xbx
Banda,\ Togbo-Vara=tor
Austral=aut
Barein=bva
Chayahuita=cbt
Ndunga=ndt
Kinnauri,\ Chitkuli=cik
Sherbro=bun
Indonesian=id
Dari,\ Zoroastrian=gbz
Mundani=mnf
Ron=cla
Mundang=mua
Kachchi=kfr
Siculo\ Arabic=sqr
Ambae,\ West=nnd
Megam=mef
Kahe=hka
Hmong,\ Southern\ Guiyang=hmy
Pima\ Bajo=pia
Ama\ (Papua\ New\ Guinea)=amm
Herero=hz
Pahlavani=phv
Chatino,\ Nopala=cya
Vera'a=vra
Doghoro=dgx
Kumyk=kum
Dhanwar\ (Nepal)=dhw
'Auhelawa=kud
Quechua,\ San\ Martín=qvs
Kongo,\ San\ Salvador=kwy
Yuanjiang-Mojiang\ Yi=yym
Sierra\ Leone\ Sign\ Language=sgx
Fore=for
Dacian=xdc
Quechua,\ Corongo\ Ancash=qwa
Lobu,\ Tampias=low
Kakauhua=kbf
Taloki=tlk
Baoulé=bci
Naaba=nao
Busuu=bju
Mbabaram=vmb
Nanggu=ngr
Jukun\ Takum=jbu
Adhola=adh
Fataluku=ddg
Odual=odu
Elkei=elk
Huave,\ San\ Mateo\ Del\ Mar=huv
Birale=bxe
Salchuq=slq
Kafa=kbr
Wasembo=gsp
Mbulungish=mbv
Dhimal=dhi
Oroqen=orh
Uneme=une
Grenadian\ Creole\ English=gcl
Daju,\ Dar\ Daju=djc
Lara'=lra
Iñapari=inp
Yanomamö=guu
Mewati=wtm
Ndunda=nuh
Cumeral=cum
Yanomámi=wca
Jemez=tow
Kibet=kie
Pyen=pyy
Ese=mcq
Dyaberdyaber=dyb
Nankina=nnk
Mainfränkisch=vmf
English\ (Philippines)=en
Ashéninka,\ South\ Ucayali=cpy
Pemon=aoc
Seke\ (Nepal)=skj
Daju,\ Dar\ Sila=dau
Anuki=aui
Rapa=ray
Irula=iru
Nilamba=nim
Puluwatese=puw
Tzotzil,\ Zinacantán=tzz
Aromanian=rup
Bishuo=bwh
Kado=kdv
Ere=twp
Nahali=nlx
Nahuatl,\ Isthmus-Pajapan=nhp
El\ Molo=elo
Roviana=rug
Huastec,\ Veracruz=hus
Ibanag=ibg
Hungarian\ (Hungary)=hu
Luhu=lcq
Susu=sus
Bussa=dox
Ngandi=nid
Kiwai,\ Northeast=kiw
Yau\ (Morobe\ Province)=yuw
Malay,\ Bacanese=btj
Tzotzil,\ Huixtán=tzu
Tabriak=tzx
Toposa=toq
Brokkat=bro
Imroing=imr
Masela,\ East=vme
Mambwe-Lungu=mgr
Mewari=mtr
Tagdal=tda
Malimba=mzd
Aghem=agq
Mongolian,\ Classical=cmg
Yi,\ Eastern\ Nisu=nos
Arapaso=arj
Rang=rax
Moldovan=mo
Bago-Kusuntu=bqg
Bislama=bi
Cashibo-Cacataibo=cbr
Suri=suq
Bonerate=bna
Epi-Olmec=xep
Iku-Gora-Ankwa=ikv
Nahuatl,\ Orizaba=nlv
Botlikh=bph
Wawonii=wow
Kurichiya=kfh
Kamantan=kci
Seget=sbg
Pulabu=pup
Halang\ Doan=hld
Kalagan,\ Tagakaulu=klg
Hong\ Kong\ Sign\ Language=hks
Lufu=ldq
Chin,\ Chinbon=cnb
Aguaruna=agr
Kaba=ksp
Rama=rma
Papapana=ppn
Amanayé=ama
Foma=fom
Nahuatl,\ Morelos=nhm
Kaan=ldl
Yiddish,\ Western=yih
Pana\ (Burkina\ Faso)=pnq
Ngad'a,\ Eastern=nea
Pulaar=fuc
Gelao,\ White=giw
Tanimuca-Retuarã=tnc
Momina=mmb
Yi,\ Naluo=ylo
Yawa=yva
Kanum,\ Bädi=khd
Enu=enu
Tugun=tzn
Urubú-Kaapor=urb
Dogon,\ Tebul\ Ure=dtu
Tzotzil,\ San\ Andrés\ Larrainzar=tzs
Kele\ (Papua\ New\ Guinea)=sbc
Lukpa=dop
Takwane=tke
Yarí=yri
Pirlatapa=bxi
Aka-Cari=aci
Suoy=syo
Saafi-Saafi=sav
Tandia=tni
Anufo=cko
Buang,\ Mangga=mmo
Busoa=bup
Indri=idr
Linear\ A=lab
Kanufi=kni
Bitur=mcc
Talodi=tlo
Spanish\ (Uruguay)=es
Gabri=gab
Zapotec,\ Totomachapan=zph
Judeo-Crimean\ Tatar=jct
Mbara\ (Chad)=mpk
Yaur=jau
Yetfa=yet
Chuukese=chk
Inuktitut\ (Western\ Canadian)=ikt
Yaul=yla
Zimakani=zik
Babar,\ Southeast=vbb
Raji=rji
Nda'nda'=nnz
Mahakam\ Kenyah=xkm
Wangaaybuwan-Ngiyambaa=wyb
Elu=elu
Shua=shg
Mararit=mgb
Kumbewaha=xks
Baelelea=bvc
Cacaopera=ccr
Khazar=zkz
Zapotec,\ Zoogocho=zpq
Karen,\ Phrae\ Pwo=kjt
Thai\ (Thailand)=th
Motu=meu
Malayic\ Dayak=xdy
Mazatec,\ Chiquihuitlán=maq
Lubu=lcf
Sukurum=zsu
Segai=sge
Mota=mtt
Yi,\ Sani=ysn
Moksela=vms
Teke-Fuumu=ifm
Centúúm=cet
Iloko=ilo
Vasavi=vas
Manichaean\ Middle\ Persian=xmn
Suma=sqm
Eki=eki
Naga,\ Tangkhul=nmf
Kwoma=kmo
Greek\ Sign\ Language=gss
Takestani=tks
Afrikaans=af
Ghodoberi=gdo
Georgian=ka
Adap=adp
Yasa=yko
Kapinawá=xpn
Rikbaktsa=rkb
Guayabero=guo
Byangsi=bee
Adai=xad
Miwok,\ Lake=lmw
Maleng=pkt
Njen=njj
Sula=szn
Kandawo=gam
Sholaga=sle
Alsea=aes
Dimli\ (individual\ language)=diq
Moru=mgd
Darlong=dln
Pakanha=pkn
Indonesian\ Sign\ Language=inl
Atta\ (Pamplona)=att
Israeli\ Sign\ Language=isr
Bicolano,\ Southern\ Catanduanes=bln
Moro=mor
Zambian\ Sign\ Language=zsl
Maori=mi
Suku=sub
Forak=frq
Puyo-Paekche=xpp
Oruma=orr
Ojibwa,\ Northwestern=ojb
Awabakal=awk
Suki=sui
Sangu\ (Gabon)=snq
Limburgan=li
Gedaged=gdd
Mesme=zim
Media\ Lengua=mue
Dubli=dub
Tamang,\ Western=tdg
Mócheno=mhn
Baikeno=bkx
Senoufo,\ Tagwana=tgw
Saruga=sra
Santali=sat
Odut=oda
Anuak=anu
Darkhat=drh
Lakkia=lbc
Zanaki=zak
Lua'=prb
Punjabi=pa
Loloda=loa
Garasia,\ Rajput=gra
Rao=rao
Kinnauri=kfk
Pelende=ppp
Bagvalal=kva
Kasua=khs
Mburku=bbt
Quechua,\ Arequipa-La\ Unión=qxu
Burate=bti
Penchal=pek
Bodo\ (Central\ African\ Republic)=boy
Toromono=tno
Pumi,\ Southern=pmj
Yonaguni=yoi
German\ (Germany)=de
Rotokas=roo
Belize\ Kriol\ English=bzj
Ahtena=aht
Kekchí=kek
Comorian,\ Mwali=wlc
Songomeno=soe
Carútana=cru
Nde-Gbite=ned
Shor=cjs
Bushi=buc
Ega=ega
Simple\ English=simple
Pokomchí,\ Western=pob
Arabic\ (Kuwait)=ar
Tarangan,\ East=tre
Rade=rad
Ntomba=nto
Labo\ Phowa=ypb
Gurung,\ Western=gvr
Dimasa=dis
Paicî=pri
Sarudu=sdu
Salinan=sln
Mahongwe=mhb
Mbum=mdd
Khamba=kbg
Agta,\ Casiguran\ Dumagat=dgc
Sumo-Mayangna=sum
Hamba=hba
Namla=naa
Efe=efe
Eastern\ Hongshuihe\ Zhuang=zeh
Madagascar\ Sign\ Language=mzc
Arapaho=arp
Ömie=aom
Baga\ Koga=bgo
Russian\ Sign\ Language=rsl
Moni=mnz
Xipináwa=xip
Huave,\ San\ Francisco\ Del\ Mar=hue
Ejamat=eja
Yana=ynn
Hamap=hmu
Mundat=mmf
Amami-Oshima,\ Northern=ryn
Kayan,\ Baram=kys
Pa'a=pqa
Bayot=bda
Naga,\ Poumei=pmx
Suga=sgi
Zapotec,\ Lachiguiri=zpa
Nahuatl,\ Isthmus-Cosoleacaque=nhk
Mawa\ (Chad)=mcw
Welaung=weu
Morisyen=mfe
Honduras\ Sign\ Language=hds
Nyulnyul=nyv
Dameli=dml
Paynamar=pmr
Quechua,\ Chilean=cqu
Yami=tao
Cakchiquel,\ Northern=ckc
Waray\ (Australia)=wrz
Oscan=osc
Erokwanas=erw
Moma=myl
Lingkhim=lii
Bilakura=bql
Lishana\ Deni=lsd
Waorani=auc
Chortí=caa
Foau=flh
Podena=pdn
Nupe-Nupe-Tako=nup
Bamenyam=bce
Paasaal=sig
Mbu'=muc
Molo=zmo
Gavião,\ Pará=gvp
Mahali=mjx
Atampaya=amz
Wagawaga=wgw
Yale=nce
Niksek=gbe
Lianshan\ Zhuang=zln
Yahuna=ynu
Yala=yba
Mixtec,\ San\ Juan\ Colorado=mjc
Mandjak=mfv
Huitoto,\ Minica=hto
Negeri\ Sembilan\ Malay=zmi
Kaili,\ Ledo=lew
Nkukoli=nbo
Balti=bft
Buang,\ Mapos=bzh
Bishnupriya=bpy
Dumbea=duf
Ujir=udj
Aizi,\ Mobumrin=ahm
Kurdish=ku
Mískito=miq
Darmiya=drd
Tobati=tti
Mufian=aoj
Namia=nnm
Popoloca,\ Coyotepec=pbf
Romani,\ Welsh=rmw
Naga,\ Khiamniungan=nky
Mbre=mka
Chinantec,\ Quiotepec=chq
Oloma=olm
Buriat,\ Russia=bxr
West\ Frisian=fy
Chukwa=cuw
Crow=cro
Mohegan-Montauk-Narragansett=mof
Torá=trz
Nahuatl,\ Central\ Huasteca=nch
Ticuna=tca
Awyu\ (South)=aws
Tseku=tsk
Nekgini=nkg
Mocho=mhc
Hindko,\ Southern=hnd
Cakchiquel,\ Santo\ Domingo\ Xenacoj=ckj
Kalinga,\ Upper\ Tanudan=kgh
Kankanaey=kne
Karo\ (Brazil)=arr
Futuna,\ East=fud
Chadong=cdy
Mochi=old
Grebo,\ Barclayville=gry
Mesquakie=sac
Frisian,\ Western=fy
Tonsawang=tnw
Malapandaram=mjp
Touo=tqu
Nukuoro=nkr
Chin,\ Mro=cmr
Moji=ymi
Patamona=pbc
Thai\ (Thailand,TH)=th
Zuni=zun
Hungworo=nat
Coeur\ d'Alene=crd
Daro-Matu=dro
Yaouré=yre
Toto=txo
Mamulique=emm
Láadan=ldn
Arawum=awm
Panjabi,\ Mirpur=pmu
Bulu\ (Cameroon)=bum
Samo,\ Southern=sbd
Samvedi=smv
Kara-Kalpak=kaa
Subi=xsj
Ngamini=nmv
Jumjum=jum
Isoko=iso
Suba=sxb
Ikposo=kpo
Dabarre=dbr
Busam=bxs
Arabic\ (Iraq)=ar
Mboi=moi
Duguza=dza
Kunimaipa=kup
Mangas=zns
Suau=swp
Min\ Zhong\ Chinese=czo
Zulu=zu
Kaansa=gna
Mbangwe=zmn
Urumi=uru
Malagasy,\ Tandroy-Mahafaly=tdx
Masela,\ West=mss
Bangandu=bgf
Wiradhuri=wrh
Liabuku=lix
Abinomn=bsa
Parakanã=pak
Pampanga=pam
Worora=unp
Halkomelem=hur
Watam=wax
Swahili\ (specific)=swh
Korubo=xor
Liburnian=xli
Venetian=vec
Toro=tdv
Mirgan=zrg
Ngongo=noq
Chinese\ (Hong\ Kong)=zh
Ejagham=etu
Damakawa=dam
Buraka=bkg
Mari\ (Russia)=chm
Bimoba=bim
Pinai-Hagahai=pnn
Winyé=kst
Jah\ Hut=jah
Gorakor=goc
Baloi=biz
Ososo=oso
Uncoded\ languages=mis
Guliguli=gli
Kaska=kkz
Isconahua=isc
Kumba=ksm
Lele\ (Guinea)=llc
Yafi=wfg
Vietnamese\ (Vietnam)=vi
Apma=app
Kurukh=kru
Gbe,\ Tofin=tfi
Enwan\ (Edu\ State)=env
Jeri\ Kuo=jek
Edopi=dbf
Zapotec,\ Aloápam=zaq
Kinnauri,\ Bhoti=nes
Nawuri=naw
Chumash=chs
Thurawal=tbh
Marquesan,\ South=mqm
Buli\ (Indonesia)=bzq
Kuman=kue
Kumam=kdi
Baygo=byg
Roria=rga
Kumak=nee
Hmong,\ Southwestern\ Huishui=hmh
Thai,\ Southern=sou
Yabong=ybo
Keningau\ Murut=kxi
Kwalhioqua-Tlatskanai=qwt
Turumsa=tqm
Ganzi=gnz
Tanacross=tcb
Demisa=dei
Hmong,\ Eastern\ Qiandong=hmq
Ganza=gza
Ekajuk=eka
Kalapuya=kyl
Naga,\ Mzieme=nme
Uisai=uis
Arabic\ (Algerian\ Sahara)=aao
Hixkaryána=hix
Dolgan=dlg
Bharia=bha
Nambo=ncm
Giiwo=kks
Lorung,\ Northern=lbr
Yugoslavian\ Sign\ Language=ysl
Gadang=gdk
Cayubaba=cyb
Huastec,\ Southeastern=hsf
Kinga=zga
Suundi=sdj
Armenian,\ Middle=axm
Pu-Xian\ Chinese=cpx
Yiwom=gek
Izora=cbo
Domari=rmt
Namat=nkm
Assan=xss
Zhoa=zhw
Tày\ Tac=tyt
Zuojiang\ Zhuang=zzj
Wagdi=wbr
Hittite,\ Old=oht
American\ Sign\ Language=ase
Chukot=ckt
Tamki=tax
Kafoa=kpu
Lillooet=lil
Loma\ (Côte\ d'Ivoire)=loi
Yopno=yut
Dza=jen
Yiddish,\ Eastern=ydd
Semnam=ssm
Karen,\ Pa'o=blk
Minangkabau=min
Yace=ekr
Cinda-Regi-Tiyal=cdr
Eten=etx
Monzombo=moj
Guguyimidjir=kky
Mmaala=mmu
Gbe,\ Maxi=mxl
Koreguaje=coe
Assiniboine=asb
Galice=gce
(Multiple)=mul
Navajo=nv
Burmese,\ Old=obr
Kajaman=kag
Baetora=btr
Edolo=etr
Sénoufo,\ Senara=seq
Gawar-Bati=gwt
Bobongko=bgb
Setaman=stm
Nugunu\ (Cameroon)=yas
Ladakhi=lbj
Moba=mfq
Toma=tod
Tamil=ta
Hmong,\ Northern\ Mashan=hmp
Nyanja=ny
Atakapa=aqp
Ixil,\ Nebaj=ixi
Shau=sqh
Lilau=lll
Medumba=byv
Tairora,\ South=omw
Nisi=dap
Shan=shn
Bafanji=bfj
Molale=mbe
Nisa=njs
Burarra=bvr
Nding=eli
Atruahí=atr
Talaud=tld
Quechua,\ Southern\ Pastaza=qup
Lamalera=lmr
Northern\ Muji=ymx
Efate,\ South=erk
Ura\ (Vanuatu)=uur
Nguluwan=nuw
Kasem=xsm
Duguri=dbm
Wangganguru=wgg
Cree=cr
Ladin=lld
Baibai=bbf
Nkoroo=nkx
Siwai=siw
Hmong\ Don=hmf
One,\ Southern=osu
Susuami=ssu
Kpati=koc
Ekpeye=ekp
Kominimung=xoi
Boikin=bzf
Bena\ (Nigeria)=yun
Cakfem-Mushere=cky
Mumuye=mzm
Syriac,\ Classical=syc
Gants=gao
Mongolian,\ Middle=xng
Mixtec,\ Magdalena\ Peñasco=xtm
Kurudu=kjr
Tupinambá=tpn
Newar,\ Middle=nwx
North\ Frisian=frr
Arutani=atx
Phende=pem
Quechua,\ Huamalíes-Dos\ de\ Mayo\ Huánuco=qvh
Buyang=byu
Khün=kkh
Likwala=kwc
Wagaya=wga
Aché=guq
Fayu=fau
Malay,\ Tenggarong\ Kutai=vkt
Nyanga=nyj
Pahari,\ Mahasu=bfz
Momuna=mqf
Tai\ Thanh=tmm
Chuvantsy=xcv
Agta,\ Umiray\ Dumaget=due
Leningitij=lnj
Warumungu=wrm
Swiss-Italian\ Sign\ Language=slf
Sungkai=suu
Wintu=wit
Pataxó-Hãhaãi=pth
Rukai=dru
Phuza=ypz
Yareba=yrb
Kwinti=kww
Manambu=mle
Machinga=mvw
Zhaba=zhb
Arabic\ (North\ Mesopotamian)=ayp
Muscogee=mus
Tarangan,\ West=txn
Dawawa=dww
Hpon=hpo
Burun=bdi
Aleut=ale
Spanish\ (Costa\ Rica)=es
Arabic\ (Bahrain)=ar
Timucua=tjm
Burui=bry
Dongotono=ddd
Miju-Mishmi=mxj
Tidore=tvo
Northern\ Sami=se
Kwinsu=kuc
Serrano=ser
Zapotec,\ Mazaltepec=zpy
Lehar=cae
Warrwa=wwr
Maonan=mmd
Gizrra=tof
English\ (India)=en
Nung\ (Myanmar)=nun
Etebi=etb
Quechua,\ Panao\ Huánuco=qxh
Mixe,\ Quetzaltepec=pxm
Kangri=xnr
Quiché,\ San\ Andrés=qxi
Kaburi=uka
Mbe'=mtk
Lahnda=lah
Carrier=crx
Mixtec,\ Amoltepec=mbz
Gbe,\ Xwela=xwe
Penan,\ Western=pne
Abure=abu
Aguano=aga
Jere=jer
Toga=lht
Shelta=sth
Taiwan\ Sign\ Language=tss
Nimo=niw
Navarro-Labourdin\ Basque=bqe
Nimi=nis
Syriac=syr
Mixe,\ Mazatlán=mzl
Mituku=zmq
Ngurmbur=nrx
Monumbo=mxk
Kangjia=kxs
Dayao\ Yi=yio
Cuyonon=cyo
Bolyu=ply
Zapotec,\ San\ Baltazar\ Loxicha=zpx
Manza=mzv
Luwian,\ Cuneiform=xlu
Mbay=myb
Klamath-Modoc=kla
Lugbara=lgg
Amahai=amq
Kwaza=xwa
Korean\ Sign\ Language=kvk
Huarijio=var
Gumawana=gvs
Indonesian\ (Indonesia)=in
Dakota=dak
Pipil=ppl
Yangulam=ynl
Korean,\ Middle\ (10th\ -\ 16th\ cent.)=okm
Matlatzinca,\ Atzingo=ocu
Qila\ Muji=ymq
Nila=nil
Ambulas=abt
Manya=mzj
Tai\ Hongjin=tiz
Maiwa\ (Indonesia)=wmm
Guya=gka
Quechua,\ Southern\ Conchucos\ Ancash=qxo
Kwaya=kya
Langam=lnm
Nahuatl,\ Western\ Huasteca=nhw
Carolinian=cal
Angor=agg
Ditammari=tbz
Zapotec,\ Yautepec=zpb
Nengone=nen
Tidong=tid
Yalakalore=xyl
Adonara=adr
Vasekela\ Bushman=vaj
Sumbawa=smw
Ayi\ (Papua\ New\ Guinea)=ayq
Zapotec,\ Petapa=zpe
Balau=blg
Indian\ Sign\ Language=ins
Bengali=bn
Shona=sn
Fasu=faa
Nkhumbi=khu
Masmaje=mes
Toda=tcx
Kpelle=kpe
Mushungulu=xma
Fwâi=fwa
Sallands=sdz
Dom=doa
Iwur=iwo
Zauzou=zal
Doe=doe
Inupiaq=ik
Konkani\ (generic)=kok
Zimbabwe\ Sign\ Language=zib
Kham,\ Gamale=kgj
Katkari=kfu
Abung=abl
Lala-Roba=lla
Nicobarese,\ Central=ncb
Capiznon=cps
Judeo-Tat=jdt
Inupiak=ik
Kalinga,\ Lower\ Tanudan=kml
Tondano=tdn
Simeku=smz
Nyika\ (Malawi\ and\ Zambia)=nkv
Karkin=krb
Uighur,\ Old=oui
Nisenan=nsz
Mwera\ (Chimwera)=mwe
Hunsrik=hrx
Jeng=jeg
Songhay,\ Koyra\ Chiini=khq
Sengele=szg
Kpala=kpl
Itneg,\ Inlaod=iti
Onobasulu=onn
Taushiro=trr
Ngete=nnn
Garawa=gbc
Hadiyya=hdy
Totonac,\ Yecuatla=tlc
Rakhine=rki
Puinave=pui
Tobo=tbv
Norwegian\ Nynorsk=nn
Oirat,\ Written=xwo
Tamajeq,\ Tayart=thz
Uma'\ Lung=ulu
Kwerba\ Mamberamo=xwr
Toba=tob
Kamba\ (Kenya)=kam
Heiban=hbn
Kyenele=kql
Bo\ (Papua\ New\ Guinea)=bpw
Halia=hla
Zazao=jaj
Moksha=mdf
Dusun\ Witu=duw
Likum=lib
Frisian,\ Eastern=frs
Chaldean\ Neo-Aramaic=cld
Tatuyo=tav
Kela\ (Democratic\ Republic\ of\ Congo)=kel
Ritarungo=rit
Malay,\ Berau=bve
Totonac,\ Papantla=top
Kenaboi=xbn
Singpho=sgp
Adi\ (Galo)=adl
Kayagar=kyt
Tonkawa=tqw
Makasar=mak
Dohoi=otd
Toba-Maskoy=tmf
Boko\ (Benin)=bqc
Kwato=kop
Arawak=arw
Luri,\ Northern=lrc
Makasae=mkz
Bomwali=bmw
Manta=myg
Kolbila=klc
Kimré=kqp
Limba,\ East=lma
Pardhan=pch
Kaningdon-Nindem=kdp
Zizilivakan=ziz
Balangingi=sse
Dungu=dbv
Koireng=nkd
Ghanaian\ Sign\ Language=gse
Marsian=ims
Gvoko=ngs
Gadaba,\ Mudhili=gau
Jabutí=jbt
Bissa=bib
Sinhalese=si
Zumbun=jmb
Mansi=mns
Chenchu=cde
Aka-Bo=akm
Nomaande=lem
Tunggare=trt
Tay\ Boi=tas
Bakwé=bjw
Phupa=ypp
Tebilung=tgb
Malay,\ Banda=bpq
Lachi,\ White=lwh
Mayo=mfy
Shilluk=shk
Keiyo=eyo
Leti\ (Cameroon)=leo
Shark\ Bay=ssv
Laragia=lrg
Fars,\ Northwestern=faz
Guro=goa
Bahinemo=bjh
Marquesan,\ North=mrq
Nsongo=nsx
Chontal,\ Lowland\ Oaxaca=clo
Utarmbung=omo
Mulaha=mfw
Musasa=smm
Laha\ (Indonesia)=lhh
Gogodala=ggw
Limburgian=li
Stieng,\ Bulo=sti
Bongili=bui
Manda\ (India)=mha
Bicolano,\ Iriga=bto
Torricelli=tei
Kimbundu=kmb
Dii=dur
Toura\ (Côte\ d'Ivoire)=neb
Lumba-Yakkha=luu
Sanggau=scg
Hmong\ Daw=mww
Tapeba=tbb
Korean\ (South\ Korea)=ko
Burji=bji
Dia=dia
Duala=dua
Teke-Laali=lli
Koguryo=zkg
Pouye=bye
Ilongot=ilk
Dyan=dya
Domaaki=dmk
Nicobarese,\ Car=caq
Totela=ttl
Judeo-Italian=itk
Fali=fli
Valman=van
Nahuatl,\ Michoacán=ncl
Neapolitan=nap
Kamasau=kms
Samaritan=smp
Uab\ Meto=aoz
Li'o=ljl
Fala=fax
Alo\ Phola=ypo
Fungwa=ula
Tharu,\ Kochila=thq
Okinawan,\ Central=ryu
Tunebo,\ Central=tuf
Bolon=bof
Phuma=ypm
Mamanwa=mmn
Asmat,\ Central=cns
Serua=srw
Koorete=kqy
Oirat=xal
Dirasha=gdl
Teke-Tege=teg
Pintiini=pti
Guntai=gnt
Quechua,\ Classical=qwc
Bughotu=bgt
Sichuan\ Yi=ii
Irish\ Sign\ Language=isg
Sanye=ssn
Makhuwa-Shirima=vmk
Tchumbuli=bqa
Gbe,\ Kotafon=kqk
Phula=phh
Mixe,\ Totontepec=mto
Nias=nia
Halbi=hlb
Washo=was
South\ Picene=spx
Awing=azo
Chumburung=ncu
Djiwarli=djl
Paraguayan\ Sign\ Language=pys
Phupha=yph
Malaryan=mjq
Karachay-Balkar=krc
Gbe,\ Ci=cib
Ganda=lg
Bamukumbit=bqt
Alege=alf
Kwang=kvi
Wogeo=woc
Talur=ilw
Akurio=ako
Tairora,\ North=tbg
Lemnian=xle
Khalaj=kjf
Kinabalian=cbw
Mangerr=zme
Dem=dem
Mato=met
Zaghawa=zag
Dek=dek
Amharic=am
Naga,\ Zeme=nzm
Boguru=bqu
Deg=mzw
Wadaginam=wdg
Efate,\ North=llp
Bai,\ Northern=bfc
Wiaki=wii
Nugunu\ (Australia)=nnv
Kwami=ktf
East\ Cree\ (Northern)=crl
Balantak=blz
Mixtec,\ San\ Juan\ Teita=xtj
Zabana=kji
Kwama=kmq
Tigre=tig
Taworta=tbp
Tanana,\ Upper=tau
Fulfulde,\ Central-Eastern\ Niger=fuq
Tuparí=tpr
Tektiteko=ttc
Bantoanon=bno
Wewaw=wea
Ili'uun=ilu
Ngalum=szb
Ncane=ncr
Mbelime=mql
Retta=ret
Palembang=plm
Spanish\ (Panama)=es
Gule=gly
Phuie=pug
Horuru=hrr
Maru=mhx
Guduf-Gava=gdf
Nalik=nal
Uokha=uok
Ulau-Suain=svb
Roglai,\ Cacgia=roc
Afrihili=afh
Naga,\ Phom=nph
Guramalum=grz
Zapotec,\ Santa\ Inés\ Yatzechi=zpn
Aore=aor
Mara=mec
Nottoway=ntw
Spanish\ (Colombia)=es
Bateri=btv
Xetá=xet
Karon=krx
Papiamento=pap
Ghari=gri
Karok=kyh
Angal=age
Yuhup=yab
Ngbundu=nuu
Naga,\ Khezha=nkh
Dhuwal=duj
Merey=meq
Kulfa=kxj
Arabic\ (Qatar)=ar
Lenkau=ler
Quechua,\ Jauja\ Wanca=qxw
Adzera=azr
Quechua,\ Cajatambo\ North\ Lima=qvl
Jangshung=jna
Haida,\ Southern=hax
Day=dai
Agavotaguerra=avo
Bisis=bnw
Mori\ Bawah=xmz
Nganyaywana=nyx
Luxembourgish=lb
Konda-Dora=kfc
Bajau,\ Indonesian=bdl
Somray=smu
Kwaja=kdz
Liujiang\ Zhuang=zlj
Yaben=ybm
Merei=lmb
Dao=daz
Dan=daf
Yabem=jae
Mangbutu=mdk
Nivaclé=cag
Sansu=sca
Cornish,\ Old=oco
Chorote,\ Iyo'wujwa=crq
Pyu=pby
Dai=dij
Lamkang=lmk
Seroa=kqu
Shoo-Minda-Nye=bcv
Minoan=omn
Bolia=bli
Juang=jun
Lohar,\ Lahul=lhl
Mape=mlh
Gwandara=gwn
Ibaloi=ibl
Somrai=sor
Kachari=xac
Tampulma=tpm
Sansi=ssi
Kwaio=kwd
Mixtec,\ Mixtepec=mix
Lepontic=xlp
Tanahmerah=tcm
Kagayanen=cgc
Baraamu=brd
Cabiyarí=cbb
Dyirbal=dbl
Chagatai=chg
Saweru=swr
Kimki=sbt
Chippewa=ciw
Iatmul=ian
Ndaktup=ncp
Nahuatl,\ Ometepec=nht
Hozo=hoz
Sinyar=sys
Zapotec,\ Güilá=ztu
Dungra\ Bhil=duh
Nusu=nuf
Burak=bys
Chochotec=coz
Akar-Bale=acl
Otomi,\ Ixtenco=otz
Malavedan=mjr
Cofán=con
Pfaelzisch=pfl
Lodhi=lbm
Mixtec,\ Yosondúa=mpm
Manx=gv
Abun=kgr
Tampuan=tpu
Sumerian=sux
Tohono\ O'odham=ood
Berbice\ Creole\ Dutch=brc
Bolgo=bvo
Sudovian=xsv
Kadazan,\ Labuk-Kinabatangan=dtb
Kol\ (Cameroon)=biw
Abui=abz
Old\ Newari=nwc
Mazahua\ Central=maz
Mann=mev
Tayo=cks
Dani,\ Upper\ Grand\ Valley=dna
Bebeli=bek
Chittagonian=ctg
Bashkardi=bsg
Abua=abn
Bebele=beb
Mango=mge
Mang=zng
Wambaya=wmb
Naga,\ Mao=nbi
Pwapwa=pop
Otomi,\ Estado\ de\ México=ots
Tahitian=ty
Pitcairn-Norfolk=pih
Ndumu=nmd
Chenoua=cnu
Penan,\ Eastern=pez
Tutelo=tta
Mlabri=mra
Karko=kko
Lawa,\ Western=lcp
Balangao=blw
Kisi,\ Southern=kss
Mada\ (Nigeria)=mda
Ansus=and
Chaungtha=ccq
Mixtec,\ Alcozauca=xta
Mama=mma
Mághdì=gmd
Misima-Paneati=mpx
Baluan-Pam=blq
Brithenig=bzt
Torres\ Strait\ Creole=tcs
Komyandaret=kzv
Kholok=ktc
Yuracare=yuz
Yindjibarndi=yij
Sowanda=sow
Malo=mla
Zigula=ziw
Kyak=bka
Dogon,\ Donno\ So=dds
Dagik=dec
Waffa=waj
Quechua,\ Puno=qxp
Mali=gcc
Bitare=brt
Nalca=nlc
Manem=jet
Tyaraity=woa
Finnish-Swedish\ Sign\ Language=fss
Balaesang=bls
Yi,\ Western\ Lalu=ywl
Bintauna=bne
Bwanabwana=tte
Wiarumus=tua
Fijian,\ Western=wyy
Sorsogon,\ Masbate=bks
Dhodia=dho
Kudmali=kyw
Kwerisa=kkb
Gudu=gdu
Maaka=mew
Sasaru=sxs
Tunebo,\ Western=tnb
Bozo,\ Tièma\ Cièwè=boo
Phuan=phu
Guarayu=gyr
Razajerdi=rat
Kwadi=kwz
Gude=gde
Biao\ Mon=bmt
Tukang\ Besi\ South=bhq
Comorian,\ Ndzwani=wni
Alta\ (Northern)=aqn
Kyerung=kgy
Belarusian=be
Pangwali=pgg
Boghom=bux
Keliko=kbo
Acoli=ach
Opao=opo
Boano\ (Maluku)=bzn
Tama\ (Chad)=tma
Iwam=iwm
Lunanakha=luk
Puari=pux
Iwal=kbm
Mixtec,\ Jamiltepec=mxt
Tembo\ (Motembo)=tmv
Tiruray=tiy
Holma=hod
Akolet=akt
Kumzari=zum
Koiari,\ Grass=kbk
Nkutu=nkw
Nachering=ncd
Krahn,\ Eastern=kqo
Xamtanga=xan
Bai,\ Central=bca
Quichua,\ Santiago\ del\ Estero=qus
Tagalog=tl
Kerinci=kvr
Kofei=kpi
Kumiai=dih
Titan=ttv
Batak\ Mandailing=btm
Amba\ (Solomon\ Islands)=utp
Buxinhua=bxt
Maii=mmm
Hoti=hti
Laeko-Libuat=lkl
Ladino=lad
Dumun=dui
Hote=hot
Lambichhong=lmh
Maia=sks
Kaonde=kqn
Spokane=spo
Etkywan=ich
Chinantec,\ Palantla=cpa
Nume=tgs
French\ (Belgium)=fr
Abon=abo
Abom=aob
Teke-Nzikou=nzu
Saxon,\ Upper=sxu
Krumen,\ Pye=pye
Ngomba=jgo
Kulung\ (Nigeria)=bbu
German,\ Pennsylvania=pdc
Umotína=umo
Okodia=okd
Jagoi=sne
Chiru=cdf
Zapotec,\ Asunción\ Mixtepec=zoo
Manam=mva
Moldavian=mol
Mazatec,\ Soyaltepec=vmp
Osatu=ost
Kantosi=xkt
Manangba=nmm
Mbule=mlb
Karey=kyd
Hruso=hru
Mbula=mna
Biyo=byo
Punic=xpu
Albanian\ (Gheg)=aln
Kadazan,\ Coastal=kzj
Desano=des
Lithuanian\ (Lithuania)=lt
Nduga=ndx
Horo=hor
Mbuko=mqb
Efik=efi
Kimbu=kiv
Spanish\ (Mexico)=es
Keiga=kec
Spanish\ (Dominican\ Republic)=es
Phrygian=xpg
Tring=tgq
Serer=srr
Nhuwala=nhf
Baybayanon=bvy
Chodri=cdi
Seeku=sos
Wãpha=juw
Pom=pmo
Hrangkhol=hra
Lachi=lbt
Yansi=yns
Mafa=maf
Sanie=ysy
Klao=klu
Ashéninka\ Perené=prq
Esan=ish
Wandala=mfi
Gupapuyngu=guf
Nauete=nxa
Dagbani=dag
Emberá-Baudó=bdc
Cun=cuq
Maya,\ Yucatán=yua
Xegwi=xeg
Waimaha=bao
Bebil=bxp
Kanjobal,\ Western=knj
Maek=hmk
Tobagonian\ Creole\ English=tgh
Nyangga=nny
Isnag=isd
Hopi=hop
Mariri=mqi
Cua=cua
Dagba=dgk
Wulna=wux
Czech\ (Czech\ Republic)=cs
Gbaya\ (Sudan)=krs
Kahumamahon\ Saluan=slb
Gonja=gjn
Phalura=phl
Legbo=agb
Hmwaveke=mrk
Zirenkel=zrn
Waboda=kmx
Kistane=gru
Ixcatec=ixc
Surbakhal=sbj
Sobei=sob
Dumpu=wtf
Nayini=nyq
Karbi=mjw
Madi=grg
Khamyang=ksu
Xhosan=xh
Sango=sg
Kedang=ksx
Bati\ (Cameroon)=btc
Tuwari=tww
Uzekwe=eze
Kpagua=kuw
Yekhee=ets
Tarahumara,\ Central=tar
Naga,\ Puimei=npu
Karas=kgv
Kolami,\ Northwestern=kfb
Kanuri,\ Manga=kby
Safeyoka=apz
Chinantec,\ Lealao=cle
Kalenjin=kln
Romano-Serbian=rsb
Karao=kyj
Maco=wpc
Arabic\ (standard)=arb
Mbugu=mhd
Belanda\ Bor=bxb
Awutu=afu
Zapotec,\ Coatlán=zps
Tanzanian\ Sign\ Language=tza
Honi=how
Naga,\ Sangtam=nsa
Maca=mca
Korwa=kfp
Tigak=tgc
South\ West\ Bay=sns
Uzbek=uz
Kon\ Keu=kkn
Wolaitta=wal
Bannoni=bcm
Jutish=jut
Tami=tmy
Traveller\ Danish=rmd
Budza=bja
Shinabo=snh
Homa=hom
Bisu=bzi
Waioli=wli
Maay=ymm
Talu=yta
Holu=hol
Nakwi=nax
Bokyi=bky
Chatino,\ Western\ Highland=ctp
Marino=mrb
Dogon,\ Dogul\ Dom=dbg
Rasawa=rac
Nuer=nus
Maring=mbw
Tala=tak
Palumata=pmc
Karen,\ Lahta=kvt
Malagasy,\ Tsimihety=xmw
Nyambo=now
Marind=mrz
Wik-Iiyanh=wij
Aiklep=mwg
Yalarnnga=ylr
Nyangbo=nyb
Repanbitip=rpn
Biri=bzr
Kuku-Mangk=xmq
Luchazi=lch
Piu=pix
Turoyo=tru
Banda-Bambari=liy
Koraga,\ Korra=kfd
Mugom=muk
Angloromani=rme
Nar\ Phu=npa
Monom=moo
Aputai=apx
Sokoro=sok
Aizi,\ Aproumu=ahp
Dera\ (Nigeria)=kna
Petats=pex
Nyamal=nly
Palenquero=pln
Shatt=shj
Nga\ La=hlt
Sorkhei=sqo
Aka-Bea=abj
Nyiha=nih
Isabi=isa
Guaraní,\ Mbyá=gun
Memoni=mby
Ede\ Ije=ijj
Hassaniyya=mey
Guarani=gn
Sikaiana=sky
Con=cno
Thai,\ Northeastern=tts
Asu\ (Nigeria)=aum
Hakka=hak
Birwa=brl
Taje=pee
Abkhazian=ab
Chin,\ Senthang=sez
Gondi=gon
Vunjo=vun
Efai=efa
Karipúna=kgm
Torona=tqr
\!Xóõ=nmn
Zumaya=zuy
Koluwawa=klx
Palawano,\ Brooke's\ Point=plw
Bipi=biq
Mamvu=mdi
Ankave=aak
Kurumba,\ Betta=xub
Lamaholot=slp
Man\ Met=mml
Senggi=snu
Secoya=sey
Yupik,\ Central=esu
Krobu=kxb
Yi,\ Wuding-Luquan=ywq
Aequian=xae
Kamarian=kzx
Thracian=txh
Cemuhî=cam
Kaamba=xku
Nubi=kcn
Chakali=cli
Waddar=wbq
Hakka\ Chinese=hak
Icelandic=is
Engenni=enn
Arabic\ (Algeria)=ar
Massalat=mdg
Kayan\ River\ Kenyah=knh
Shina,\ Kohistani=plk
Daasanach=dsh
Ekari=ekg
Lhokpu=lhp
One,\ Kabore=onk
Mangseng=mbh
Tregami=trm
Kinnauri,\ Harijan=kjo
Ethiopian\ Sign\ Language=eth
Northern\ Sotho,\ Pedi=nso
Chiga=cgg
Sajalong=sjl
Bini=bin
Yi,\ Wusa\ (Wusa\ Nasu)=yig
Esimbi=ags
Bine=bon
Ayta,\ Abenlen=abp
Maninka,\ Forest=myq
Phuong=phg
Bhunjia=bhu
Hmong,\ Central\ Huishui=hmc
Mansoanka=msw
Pei=ppq
Bakole=kme
Krache=kye
Kajakse=ckq
Warlpiri=wbp
Eblan=xeb
Whitesands=tnp
Duano'=dup
Alumu-Tesu=aab
Mam,\ Tajumulco=mpf
Korop=krp
Kimaragang=kqr
Gamit=gbl
Konkani,\ Goan=gom
Hadrami=xhd
Monimbo=mom
Yelogu=ylg
Spanish\ (Honduras)=es
Bumaji=byp
Manyika=mxc
Bakoko=bkh
Tafi=tcd
Bima=bhp
Kxoe=xuu
Patep=ptp
Campalagian=cml
Isanzu=isn
Bru,\ Western=brv
Abau=aau
Kanuri,\ Central=knc
Abar=mij
Aja\ (Benin)=ajg
Nanticoke=nnt
Turka=tuz
Central\ Khmer=km
Subanen,\ Northern=stb
Gibanawa=gib
Suwawa=swu
Mala\ (Papua\ New\ Guinea)=ped
Osage=osa
Mongondow=mog
Birri=bvq
Liuqian\ Zhuang=zlq
Bile=bil
Bamako\ Sign\ Language=bog
Bila=bip
Chol,\ Tila=cti
Yango=yng
Keuru=xeu
Idesa=ids
Dilling=dil
Arabic,\ Shihhi\ Spoken=ssh
Otuke=otu
Land\ Dayak=dyk
Kukna=kex
Umatilla=uma
Tswapong=two
Chetco=ctc
Soninke=snk
Hmong\ Dô=hmv
Melanau=mel
Nyanga-li=nyc
Kinalakna=kco
Alabama=akz
Langue\ des\ signes\ de\ Belgique\ Francophone=sfb
Lawa,\ Eastern=lwl
Zapotec,\ Yatee=zty
Mariyedi=zmy
Idere=ide
Abureni=mgj
Gapapaiwa=pwg
Mondé=mnd
Ersu=ers
Faroese=fo
Slovenian\ (Slovenia)=sl
Rapting=rpt
Numanggang=nop
Arabic\ (Cypriot)=acy
Etruscan=ett
Kambaira=kyy
Réunion\ Creole\ French=rcf
Brahui=brh
Ede\ Ica=ica
Ede\ Idaca=idd
Naga,\ Yimchungru=yim
Malagasy,\ Antankarana=xmv
Quichua,\ Calderón\ Highland=qud
Warji=wji
Che=ruk
Mongo=lol
Pao=ppa
Majang=mpe
Tukang\ Besi\ North=khc
Tae'=rob
Pam=pmn
Pal=abw
Lopit=lpx
Dinka=din
Yaaku=muu
Virgin\ Islands\ Creole\ English=vic
Hmong,\ Southwestern\ Guiyang=hmg
Korku=kfq
Novial=nov
Buriat,\ China=bxu
Waris=wrs
Erre=err
Nyenkha=neh
Ugong=ugo
Tabo=knv
Bagirmi=bmi
Otuho=lot
Pumpokol=xpm
Sinasina=sst
Istriot=ist
Oki-No-Erabu=okn
Pévé=lme
Southern\ Sotho=st
Samarokena=tmj
Budibud=btp
Shom\ Peng=sii
Parawen=prw
Dakpakha=dka
Anus=auq
Maidu,\ Northeast=nmu
Alapmunte=apv
Manda\ (Tanzania)=mgs
Parenga=pcj
Erave=kjy
Khakas=kjh
Hangaza=han
Jumli=jml
Kayu\ Agung=vky
Takuu=nho
Biete=biu
Ogbia=ogb
Tibetan,\ Khams=khg
Milyan=imy
Basa\ (Cameroon)=bas
Lemoro=ldj
Cen=cen
Tsuvadi=tvd
Spanish\ (Nicaragua)=es
Biga=bhc
Aiton=aio
Takua=tkz
Kavalan=ckv
Gedeo=drs
Mixtec,\ Mitlatongo=vmm
Ede\ Nago,\ Manigri-Kambolé=xkb
Movima=mzp
Siuslaw=sis
Ngbaka\ Manza=ngg
Anindilyakwa=aoi
Selungai\ Murut=slg
Pekal=pel
Aushi=auh
Marachi=lri
Scots=sco
Itneg,\ Masadiit=tis
Ngando\ (Central\ African\ Republic)=ngd
Alviri-Vidari=avd
Mekmek=mvk
Berakou=bxv
Talysh=tly
Ngbandi,\ Southern=nbw
Sengseng=ssz
Mbwela=mfu
Kanikkaran=kev
Tillamook=til
Tututni=tuu
Karon\ Dori=kgw
Biem=bmc
Jimi\ (Nigeria)=jmi
Wares=wai
Bieria=brj
Chachi=cbi
Kenyan\ Sign\ Language=xki
Silimo=wul
'Are'are=alu
Dida,\ Lakota=dic
Flinders\ Island=fln
Cholón=cht
Danish\ Sign\ Language=dsl
Lahanan=lhn
Pakistan\ Sign\ Language=pks
Badyara=pbp
Apache\ (Lipan)=apl
Kimaama=kig
Indo-Portuguese=idb
Nagarchal=nbg
Kalumpang=kli
Doko-Uyanga=uya
Tshangla=tsj
Buglere=sab
Krahn,\ Western=krw
Enrekang=ptt
Makian,\ East=mky
Chorasmian=xco
Kumauni=kfy
Arabic,\ Tunisian\ Spoken=aeb
Kaduo=ktp
Maria\ (India)=mrr
Dakaka=bpa
Budik=tnr
Amuzgo,\ Guerrero=amu
Voro=vor
Maguindanao=mdh
Kanjobal,\ Eastern=kjb
Belait=beg
Rakahanga-Manihiki=rkh
Peruvian\ Sign\ Language=prl
Vagla=vag
Spanish\ (Chile)=es
Gitua=ggt
Wumbvu=wum
Franco-Provençal=frp
Litzlitz=lzl
Anor=anj
Arabic\ (Oman)=ar
Tanna,\ Southwest=nwi
Bokha=ybk
Marind,\ Bian=bpv
Takpa=tkk
Worodougou=jud
Cubeo=cub
Kpatili=kym
Macaguán=mbn
Uruangnirin=urn
Samre=sxm
Yiddish\ Sign\ Language=yds
Muluridyi=vmu
Bankon=abb
Sonia=siq
Javanese,\ New\ Caledonian=jas
Silesian,\ Lower=sli
Oblo=obl
Biao=byk
Biak=bhw
Samberigi=ssx
Buyu=byi
Warao=wba
Truká=tka
Kariya=kil
Kamayurá=kay
Jiiddu=jii
Taman\ (Indonesia)=tmn
Holoholo=hoo
Polish\ Sign\ Language=pso
Begbere-Ejar=bqv
Kalagan=kqe
Baimak=bmx
Buya=byy
Enets,\ Forest=enf
Assyrian\ Neo-Aramaic=aii
Owa=stn
Sonha=soi
Manda\ (Australia)=zma
Aigon=aix
Téén=lor
Tarahumara,\ Southeastern=tcu
Tai\ Dón=twh
Zapotec,\ Isthmus=zai
Songo=soo
Boko\ (Democratic\ Republic\ of\ Congo)=bkp
Gavião\ Do\ Jiparaná=gvo
Dhanwar\ (India)=dha
Mandinka=mnk
Shekhawati=swv
Songe=sop
Ogbah=ogc
Cumanagoto=cuo
Lemerig=lrz
Zapotec,\ Choapan=zpc
Songa=sgo
Tripuri,\ Early=xtr
Arabic\ (Libyan)=ayl
Shabo=sbf
Ngwo=ngn
Beli\ (Sudan)=blm
Vono=kch
Korak=koz
Cree\ (Woods)=cwd
Ngwe=nwe
Mmen=bfm
Guriaso=grx
Andaman\ Creole\ Hindi=hca
Kinabatangan,\ Upper=dmg
Sorbian,\ Upper=hsb
Gawwada=gwd
Cupeño=cup
Arabic\ (South\ Levantine)=ajp
Khiamniungan\ Naga=kix
French,\ Cajun=frc
Maisin=mbq
Nahuatl\ (Highland\ Puebla)=azz
Aari=aiw
Pinyin=pny
Piti=pcn
Barambu=brm
Bolinao=smk
Puquina=puq
Marshallese=mh
Tamang,\ Eastern\ Gorkha=tge
Oti=oti
Huizhou\ Chinese=czh
Norwegian\ Bokmål=nb
Ngalakan=nig
Gusii=guz
Pintupi-Luritja=piu
Mokerang=mft
Mingrelian=xmf
Chinantec,\ Tepetotutla=cnt
Nakai=nkj
New\ Zealand\ Sign\ Language=nzs
Nahuatl,\ Northern\ Oaxaca=nhy
Upper\ Sorbian=hsb
Yout\ Wam=ytw
Ngul=nlo
Cauca=cca
Asaro'o=mtv
Lewo=lww
Bulgarian\ Sign\ Language=bqn
Camunic=xcc
Tsikimba=kdl
Mixtec,\ Peñoles=mil
Samogitian=sgs
Sonde=shc
Ngbinda=nbd
Piru=ppr
Mixtec,\ Yucuañe=mvg
Ayabadhu=ayd
Kusaal=kus
Benga=bng
Bashkir=ba
Piro=pie
Naga,\ Khoibu=nkb
Sedoa=tvw
Mor\ (Bomberai\ Peninsula)=moq
Dendi\ (Benin)=ddn
Gurinji=gue
Sidamo=sid
Ndyuka-Trio\ Pidgin=njt
Mandingo=man
Darang\ Deng=dat
Spanish\ (Venezuela)=es
Teke-Tsaayi=tyi
Doutai=tds
Tibetan,\ Classical=xct
Beami=beo
Matsés=mcf
Avar,\ Old=oav
Djangun=djf
Anii=blo
Rengao=ren
Oro=orx
Tilung=tij
Esselen=esq
Vinmavis=vnm
Wanman=wbt
Birao=brr
Olu'bo=lul
Batak\ Angkola=akb
Armenian,\ Classical=xcl
Tringgus=trx
Buso=bso
Takia=tbc
Narango=nrg
Kuman\ (Russia)=qwm
Shama-Sambuga=sqa
Kuni-Boazi=kvg
Odoodee=kkc
Busa=bqp
Vinza=vin
Mamaa=mhf
Cishingini=asg
Aleut,\ Mednyj=mud
Tareng=tgr
Kayan\ Mahakam=xay
Nambas,\ Big=nmb
Bulu\ (Papua\ New\ Guinea)=bjl
Esuma=esm
Kwamera=tnk
Labir=jku
Chuka=cuh
Haya=hay
Bayono=byl
Njalgulgule=njl
Arára\ (Mato\ Grosso)=axg
Ndonde\ Hamba=njd
Binukid=bkd
Manobo,\ Rajah\ Kabunsuwan=mqk
Bwa=bww
Purepecha=tsz
Bure=bvh
Reshe=res
Bendi=bct
Rajbanshi=rjs
Bende=bdp
Buruwai=asi
Musom=msu
Lhomi=lhm
Yazgulyam=yah
Wiyot=wiy
Muruwari=zmu
Achuar-Shiwiar=acu
Agta,\ Alabat\ Island=dul
Iceve-Maci=bec
Broome\ Pearling\ Lugger\ Pidgin=bpl
Frankish=frk
Erzya=myv
Basa\ (Nigeria)=bzw
Chambri=can
Bench=bcq
Doondo=dde
Bru,\ Eastern=bru
Malay\ (individual\ language)=zlm
Lese=les
Nyika\ (Tanzania)=nkt
Chipiajes=cbe
Kuna,\ Border=kvn
Amaimon=ali
Bihari=bh
Ahirani=ahr
Mbukushu=mhw
\!O\!ung=oun
Tanglang=ytl
Imbongu=imo
Bun=buv
Bum=bmv
Pini=pii
Beezen=bnz
Mittu=mwu
Popoluca,\ Sayula=pos
Anem=anz
Ullatan=ull
Ono=ons
Chinook\ jargon=chn
Bua=bub
Degaru=dgu
Ong=oog
Havu=hav
Barasana=bsn
Emberá-Tadó=tdc
Ida'an=dbj
Lere=gnh
Shasta=sht
Ona=ona
Igana=igg
Bangala=bxg
Livvi=olo
French\ (France)=fr
Ayizi=yyz
Wik-Mungkan=wim
Langbashe=lna
Rathawi=rtw
Tarantino=roa-tara
Awtuw=kmn
Arabic\ (Dhofari)=adf
Ngom=nra
Munggui=mth
Daju,\ Dar\ Fur=daj
Lang'e=yne
Konkomba=xon
Buol=blf
Kraol=rka
Andi=ani
Manangkari=znk
Andh=anr
Pai\ Tavytera=pta
Karagas=kim
Quichua,\ Imbabura\ Highland=qvi
Korupun-Sela=kpq
Kurumba,\ Mullu=kpb
Omi=omi
Dungan=dng
Chuvash=cv
Fanti=fat
Binandere=bhg
Mingang\ Doso=mko
Dagaare,\ Southern=dga
Tokano=zuh
Birked=brk
Ajawa=ajw
Gusilay=gsl
Suruahá=swx
Hanga\ Hundi=wos
Algonquin=alq
Olo=ong
Label=lbb
Altai\ (Southern)=alt
Bung=bqd
Waskia=wsk
Luiseno=lui
Hindustani,\ Caribbean=hns
Langnian\ Buyang=yln
Fang\ (Equatorial\ Guinea)=fan
Gusan=gsn
Buna=bvn
Tifal=tif
Southern\ Nisu=nsd
Ashéninka\ Pajonal=cjo
Igala=igl
Cashinahua=cbs
Oku=oku
Yakoma=yky
Malaysian\ Sign\ Language=xml
Pinji=pic
Tamil,\ Old=oty
Samei=smh
Yongbei\ Zhuang=zyb
Spanish\ Sign\ Language=ssp
Zapotec=zap
Enawené-Nawé=unk
Nzakambay=nzy
Gayil=gyl
Seze=sze
Ayiwo=nfl
Antigua\ and\ Barbuda\ Creole\ English=aig
Warluwara=wrb
Squamish=squ
Krahô=xra
Cambodian=km
Anam=pda
Yindjilandji=yil
Pije=piz
Anal=anm
Cochimi=coj
Sama,\ Southern=ssb
Beaver=bea
Beli\ (Papua\ New\ Guinea)=bey
Cornish=kw
Palaic=plq
Tanaina=tfn
Yamna=ymn
Samtao=stu
Sihan=snr
Morokodo=mgc
Ani\ Phowa=ypn
Bozo,\ Hainyaxo=bzx
Quichua,\ Salasaca\ Highland=qxl
Thai\ Sign\ Language=tsq
Yi,\ Sichuan=ii
Thulung=tdh
Woria=wor
Naga,\ Ao=njo
Grebo,\ Gboloo=gec
Dinka,\ South\ Central=dib
Bajan=bjs
Ghadamès=gha
Kulina\ Pano=xpk
Makian,\ West=mqs
Mende\ (Papua\ New\ Guinea)=sim
Romani,\ Balkan=rmn
Aghu\ Tharnggalu=ggr
Bom=bmf
Creek=mus
Blang=blr
Kembra=xkw
Musgu=mug
Gooniyandi=gni
Siraya=fos
Sambe=xab
Fyer=fie
Wiru=wiu
Samba=smx
Arabic\ (Sudanese)=apd
Pauserna=psm
Bareli,\ Pauri=bfb
Faiwol=fai
Piame=pin
Zapotec,\ Xadani=zax
Reserved\ for\ local\ use=qaa
Banyumasan=map-bms
Buriat,\ Mongolia=bxm
Sambal,\ Botolan=sbl
Ngie=ngj
Malvi=mup
Hakö=hao
Asuriní=asu
Sajau\ Basap=sjb
Larevat=lrv
Sagala=sbm
Kepkiriwát=kpn
Warnang=wrn
Russian\ (Russia)=ru
Qaqet=byx
Votic=vot
Shahrudi=shm
Dwang=nnu
Achang=acn
Phunoi=pho
Musey=mse
Ofo=ofo
Béte,\ Guiberoua=bet
Ga'dang=gdg
Taupota=tpa
Lenyima=ldg
Romanian\ Sign\ Language=rms
Gujari=gju
Kadar=kej
Fataleka=far
Ketum=ktt
Damar,\ East=dmr
Foodo=fod
Komering=kge
Samburu=saq
Lembak=liw
Chuj,\ Ixtatán=cnm
Ohlone\ (Southern)=css
Hano=lml
Kadai=kzd
Hebrew\ (Israel)=iw
Tama\ (Colombia)=ten
Hani=hni
Cocopa=coc
Ho-Chunk=win
Tirahi=tra
Sylheti=syl
Piratapuyo=pir
Kaytetye=gbb
Wipi=gdr
Kalasha=kls
Ayta,\ Tayabas=ayy
Mixtec,\ Cacaloxtepec=miu
Chiripá=nhd
Kapya=klo
Turkana=tuv
Seti=sbi
Garig-Ilgar=ilg
Tonjon=tjn
Rabha=rah
Michigamea=cmm
Seta=stf
Cumbric=xcb
Beembe=beq
Kopkaka=opk
Sidetic=xsd
Cree\ (Swampy)=csw
Meroitic=xmr
Dari\ (Persian)=prd
Popoloca,\ Santa\ Inés\ Ahuatempan=pca
Kasiguranin=ksn
Urubú-Kaapor\ Sign\ Language=uks
Badaga=bfq
Biseni=ije
Arbore=arv
Bonerif=bnv
Hanunoo=hnn
Tlapanec,\ Azoyú=tpc
Fyam=pym
Ngawun=nxn
Yaminahua=yaa
Kaurna=zku
Chinese\ (Taiwan)=zh
Ngeq=ngt
Arabic\ (Algerian)=arq
Seru=szd
Chiquitano=cax
Southwestern\ Nisu=nsv
Aduge=adu
Turkish\ (Turkey)=tr
Chatino,\ Tataltepec=cta
Naga,\ Konyak=nbe
Guibei\ Zhuang=zgb
Uru-Pa-In=urp
Seri=sei
Shixing=sxg
Matagalpa=mtn
Sere=swf
Nde-Nsele-Nta=ndd
Sera=sry
Bit=bgk
Budu=buu
Gamilaraay=kld
Tawang\ Monpa=twm
Dimli=diq
Ombamba=mbm
Nuni,\ Northern=nuv
Tangshewi=tnf
Ruund=rnd
Bété,\ Daloa=bev
Xiang\ Chinese=hsn
Lesing-Gelimi=let
Musar=mmi
Rwandi=rw
Musan=mmp
Arabic\ (Baharna)=abv
Kajali=xkj
Musak=mmq
Lefa=lfa
Croatian\ (Croatia)=hr
Hunjara-Kaina\ Ke=hkk
Haji=hji
Apalik=apo
Fania=fni
Hernican=xhr
Isu\ (Fako\ Division)=szv
Xhosa=xh
Puyo=xpy
Yameo=yme
Vafsi=vaf
Dusun,\ Tambunan=kzt
Brunei=kxd
Cahuarano=cah
Grebo,\ Central=grv
Kir-Balar=kkr
Arabic\ (Najdi)=ars
Bribri=bzd
Limba,\ West-Central=lia
Sarasira=zsa
Southern\ Marakwet=tle
Tewa\ (Indonesia)=twe
West\ Berawan=zbw
Burmbar=vrt
Bonggo=bpg
Poyanáwa=pyn
Bantayanon=bfx
Chinese\ (China)=zh
Imonda=imn
Malay\ (generic)=ms
Bonggi=bdg
Western\ Frisian=fy
Vumbu=vum
Nganasan=nio
Blafe=bfh
Malol=mbk
Bubi=buw
Yaka\ (Central\ African\ Republic)=axk
Kpasam=pbn
Bube=bvb
Norwegian\ (Nynorsk)=nn
Bhattiyali=bht
Hamer-Banna=amf
Polabian=pox
Negidal=neg
Cagua=cbh
'hoan=ktz
Chinese=zh
Ngas=anc
Macedonian,\ Ancient=xmk
Dimir=dmc
Piaroa=pid
Bwela=bwl
Barikanchi=bxo
Ngam=nmc
Dominican\ Sign\ Language=doq
Dulbu=dbo
Miwok,\ Southern\ Sierra=skd
Leco=lec
Zemgalian=xzm
Kono\ (Guinea)=knu
Alagwa=wbj
Tarahumara,\ Southwestern=twr
North\ Arabian,\ Ancient=xna
Sene=sej
Mwimbi-Muthambi=mws
Sena=seh
Xakriabá=xkr
Hajong=haj
Tapirapé=taf
Malimpung=mli
Bangolan=bgj
Iberian=xib
Oro\ Win=orw
Angika=anp
Cori=cry
Tarahumara,\ Northern=thh
Amto=amt
Nafusi=jbn
Nawdm=nmz
Tasmanian=xtz
Tsogo=tsv
Barombi=bbi
Mori\ Atas=mzq
Bodo\ (India)=brx
Koasati=cku
Kyaka=kyc
Yamba=yam
Kituba\ (Democratic\ Republic\ of\ Congo)=ktu
Apalaí=apy
Lanoh=lnh
Central\ Bicolano=bcl
Subanon,\ Western=suc
Makyan\ Naga=umn
Bahau\ River\ Kenyah=bwv
Yamap=ymp
Powari=pwr
Hobyót=hoh
Bakaka=bqz
Kol\ (Papua\ New\ Guinea)=kol
Cowlitz=cow
Banda-Banda=bpd
Mander=mqr
Tokharian\ B=txb
Nootka=noo
Tokharian\ A=xto
Bellari=brw
Akuku=ayk
Kuwaa=blh
Eton\ (Vanuatu)=etn
Zapotec,\ Zaniza=zpw
Panasuan=psn
Onin=oni
Kukele=kez
Yapunda=yev
Awad\ Bing=bcu
Amri=ajz
Emai-Iuleha-Ora=ema
Lydian=xld
Seki=syi
Warungu=wrg
Libon\ Bikol=lbl
Coos=csz
Baiso=bsw
Arabic\ (Egypt)=ar
Kairiru=kxa
Serbian=sr
Norwegian=no
Mwaghavul=sur
Kalagan,\ Kagan=kll
Kinaray-A=krj
Brokskat=bkk
Messapic=cms
Greek\ (Greece)=el
Tachelhit=shi
Bau=bbd
Bungku=bkz
Kwer=kwr
Komo\ (Sudan)=xom
Bai=bdj
Pula\ Yi=ypl
Kunggari=kgl
Tujia,\ Northern=tji
Puri=prr
Laari=ldi
Danish=da
Bukiyip=ape
Habu=hbu
Kunggara=kvs
Hupla=hap
Persian\ (Dari)=prs
Kabutra=kbu
Dzalakha=dzl
Tiene=tii
Bakpinka=bbs
Namiae=nvm
Sipacapense=qum
Ligurian\ (Ancient)=xlg
Karingani=kgn
Namuyi=nmy
Pumé=yae
Masiwang=bnf
Mangayat=myj
Altai\ (Northern)=atv
Bidiyo=bid
Paumarí=pad
Trieng=stg
Mandar=mdr
Mandan=mhq
Evenki=evn
Malay,\ Sabah=msi
Kugama=kow
Parya=paq
Glaro-Twabo=glr
Ivatan=ivv
Ternateño=tmg
Late\ Middle\ Chinese=ltc
Azha=aza
Bijori=bix
Nahuatl,\ Tabasco=nhc
Wurrugu=wur
Fali,\ South=fal
Piya-Kwonci=piy
Kalaallisut=kl
Sicilian=scn
Hawaiian=haw
Katukína=kav
Alatil=alx
Ta'oih,\ Lower=tto
Gourmanchéma=gux
Blagar=beu
Dorze=doz
Waamwang=wmn
Bokobaru=bus
Curripaco=kpc
Kodia=kwp
Jumla\ Sign\ Language=jus
Finnish\ (Tornedalen)=fit
Jorá=jor
Wantoat=wnc
Tenis=tns
Tabassaran=tab
Malagasy,\ Plateau=plt
Biao-Jiao\ Mien=bje
Tauade=ttd
Samba\ Daka=ccg
Kalkoti=xka
Obolo=ann
Tagbanwa,\ Central=tgt
Gilbertese=gil
Puoc=puo
Itneg,\ Adasen=tiu
Chinantec,\ Ozumacín=chz
Pokomam,\ Southern=pou
Azerbaijani\ (North)=azj
Segeju=seg
Naga,\ Tarao=tro
Punu=puu
Njyem=njy
Minanibai=mcv
Kwangali=kwn
Lyngngam=lyg
Kwak=kwq
Mokpwe=bri
Hupdë=jup
Kango\ (Tshopo\ District)=kzy
Kuku-Mu'inh=xmp
Nuk=noc
Gronings=gos
Teribe=tfr
Berawan=lod
Sekapan=skp
Langi=lag
Teanu=tkw
Sikaritai=tty
Yukaghir,\ Southern=yux
Pomo,\ Northern=pej
Capanahua=kaq
Kapin=tbx
Aruop=lsr
Dhanki=dhn
Baima=bqh
Ebughu=ebg
Australian\ Sign\ Language=asf
Darai=dry
Rapoisi=kyx
Hmong,\ Northern\ Huishui=hmi
Bo\ (Laos)=bgl
Iresim=ire
Watakataui=wtk
Puma=pum
Itonama=ito
Baramu=bmz
Saurashtra=saz
Nama\ (Namibia)=naq
Dizi=mdx
Koromfé=kfz
Mursi=muz
Walmajarri=wmt
Aruamu=msy
Spanish\ (Peru)=es
Urak\ Lawoi'=urk
Tunebo,\ Barro\ Negro=tbn
Damar,\ West=drn
Kwa'=bko
Barama=bbg
Turaka=trh
Pidgin,\ Nigerian=pcm
Wakoná=waf
Como\ Karim=cfg
Ayu=ayu
Amis=ami
Nyaneka=nyk
Salish,\ Southern\ Puget\ Sound=slh
Gujarati=gu
Sorani=ckb
Totonac,\ Filomena\ Mata-Coahuitlán=tlp
Powhatan=pim
Kirghiz=ky
Lonzo=lnz
Ohlone\ (Northern)=cst
Awyu\ (Edera)=awy
Seba=kdg
Tajio=tdj
Malay=ms
Kaco'=xkk
Tajik=tg
Malas=mkr
Lijili=mgi
Assangori=sjg
Amarag=amg
Dogrib=dgr
Nasarian=nvh
Mlap=kja
Itu\ Mbon\ Uzo=itm
Itzá=itz
Southwestern\ Bontok=vbk
Mengaka=xmg
Dhangu=dhg
Sharwa=swq
Sighu=sxe
Serili=sve
Diriku=diu
Tomoip=tqp
Loup\ B=xlb
Maritime\ Sign\ Language=nsr
Loup\ A=xlo
Achagua=aca
Bauwaki=bwk
Alngith=aid
Gelao,\ Red=gir
Dogon,\ Bondum\ Dom=dbu
Awa=awb
Kembayan=xem
Lenakel=tnl
Suruí=sru
Chinantec,\ Sochiapan=cso
Chehalis,\ Upper=cjh
Buhi'non\ Bikol=ubl
Unserdeutsch=uln
Sepen=spm
Yukuben=ybl
Korean=ko
Noy=noy
Naga,\ Rongmei=nbu
Navut=nsw
Ginuman=gnm
Mixtec,\ Chigmecatitlán=mii
Costa\ Rican\ Sign\ Language=csr
Aramaic=arc
Wichita=wic
Uighur=ug
Romani,\ Tavringer=rmu
Wusi=wsi
Chamari=cdg
Ili\ Turki=ili
Tlingit=tli
Yanyuwa=jao
Tanna,\ North=tnn
Usui=usi
Badeshi=bdz
Elamite=elx
Kusunda=kgg
Sulung=suv
Vano=vnk
Malayo=mbp
Rendille=rel
Xokleng=xok
Kikai=kzg
Totoro=ttk
Mandandanyi=zmk
Vemgo-Mabas=vem
Sanskrit=sa
Ossetic,\ Old=oos
Khowar=khw
Bassari=bsc
Fulfulde,\ Western\ Niger=fuh
Wallisian=wls
Dani,\ Mid\ Grand\ Valley=dnt
Kickapoo=kic
Occidental=occ
Gungabula=gyf
Jaqaru=jqr
Bembe=bmb
Lala-Bisa=leb
Bahonsuai=bsu
Wè\ Southern=gxx
Bobo\ Madaré,\ Northern=bbo
Merlav=mrm
Lutos=ndy
Malango=mln
Akawaio=ake
Naga,\ Chokri=nri
Benyadu'=byd
Caquinte=cot
Rerep=pgk
Ati=atk
Vame=mlr
Brokpake=sgt
Cibak=ckl
Golin=gvf
Wauyai=wuy
Ata=atm
Alemannic\ German=als
Nshi=nsc
Unami=unm
Bragat=aof
Matengo=mgv
Tyap=kcg
Kunama=kun
Ligenza=lgz
Murle=mur
Nyang'i=nyp
Mala\ Malasar=ima
Nimbari=nmr
Eastern\ Bontok=ebk
Disa=dsi
Letemboi=nms
Ivbie\ North-Okpela-Arhe=atg
Mündü=muh
Urartian=xur
Vale=vae
Quechua,\ Chiquián\ Ancash=qxa
Dhargari=dhr
Yupik,\ Central\ Siberian=ess
Nsari=asj
Panobo=pno
Dyangadi=dyn
Zapotec,\ Santa\ María\ Quiegolani=zpi
Manobo,\ Obo=obo
Swahili\ (generic)=sw
Lama\ (Myanmar)=lay
Yale,\ Kosarek=kkl
Mozambican\ Sign\ Language=mzy
Muskum=mje
Gamo-Gofa-Dawro=gmo
Diri=dwa
Tobanga=tng
Tutchone,\ Northern=ttm
Saposa=sps
Yeretuar=gop
Angoram=aog
Waima'a=wmh
Polish=pl
Djongkang=djo
Axamb=ahb
Ambo=amb
Ari=aac
Bisaya,\ Brunei=bsb
Southwest\ Gbaya=mdo
Are=mwc
Orang\ Kanaq=orn
Andra-Hus=anx
Batak\ Karo=btx
Buli\ (Ghana)=bwu
Dogon,\ Bangeri\ Me=dba
Mbandja=zmz
Ngoshie=nsh
Bangubangu=bnx
Bisaya,\ Sabah=bsy
Greenlandic=kl
Zayse-Zergulla=zay
Bukwen=buz
Arabic\ (Omani)=acx
Aruek=aur
Amal=aad
English\ (United\ Kingdom)=en
Chiapanec=cip
Umanakaina=gdn
Tsimshian=tsi
Zeem=zua
Traveller\ Scottish=trl
Tabaru=tby
Jarai=jra
Banjar=bjn
Malay\ (Malaysia)=ms
Murik=mtf
Polish\ (Poland)=pl
Penesak=pen
Anamgura=imi
Chamorro=ch
Edomite=xdm
Tugutil=tuj
Rerau=rea
Abnaki,\ Western=abe
Sembakung\ Murut=sbr
Rutul=rut
Abron=abr
Galeya=gar
Pu\ Ko=puk
Bauzi=bvz
Pular=fuf
Yamphu=ybi
Matís=mpq
Ishkashimi=isk
Nii=nii
Molof=msl
Andoa=anb
Cogui=kog
Nyamwezi=nym
Kalarko=kba
Long\ Phuri\ Naga=lpn
Jimi\ (Cameroon)=jim
Yamphe=yma
Ambrym,\ North=mmg
Tepehua,\ Huehuetla=tee
Michif=crg
Bhili=bhb
Kalabakan=kve
Tagbanwa,\ Calamian=tbk
Folopa=ppo
Obanliku=bzy
Totoli=txe
Zaramo=zaj
Koonzime=ozm
Ngoni=ngo
Surigaonon=sul
Amdang=amj
Ngong=nnx
Masalit=mls
Ashéninka,\ Pichis=cpu
Mam,\ Southern=mms
Katabaga=ktq
Araucanian=arn
Makwe=ymk
Tangale=tan
Kaimbulawa=zka
Tokelau=tkl
Tlapanec,\ Malinaltepec=tcf
Hmong,\ Eastern\ Xiangxi=muq
Anu=anl
Ding=diz
Mapena=mnm
Nubaca=baf
Central\ Berawan=zbc
Wappo=wao
Salas=sgu
Bayali=bjy
Salar=slr
Ani=hnh
Chewong=cwg
Venetic=xve
Rotuman=rtm
Jorto=jrt
Toussian,\ Southern=wib
Zulgo-Gemzek=gnd
Macaguaje=mcl
Saponi=spi
Quechua,\ Chincha=qxc
Yombe=yom
Tchitchege=tck
Ancient\ Zapotec=xzp
Machiguenga=mcb
Dime=dim
Gangte=gnb
Amo=amo
Dima=jma
Maidu,\ Northwest\ (Konkow)=mjd
Ami=amy
Mullukmulluk=mpb
Arabic\ (Tunisia)=ar
N'Ko=nqo
Palikúr=plu
Agta,\ Villa\ Viciosa=dyg
Oksapmin=opm
Moskona=mtj
Palauan=pau
Dzodinka=add
Aguacateco=agu
Tumbuka=tum
Ali=aiy
Pictish=xpi
Usku=ulf
Nen=nqn
Ranau=rae
Norwegian\ (Bokmål)=no
Nek=nif
Kiwai,\ Southern=kjd
Fali,\ North=fll
Tai\ Daeng=tyr
Nathembo=nte
Irántxe=irn
Tsaangi=tsa
Emilian=egl
Keyagana=kyg
Sunwar=suz
Ake=aik
Ndo=ndp
Kaptiau=kbi
Kenyah,\ Wahau=whk
Aka=soh
Maba\ (Chad)=mde
Mamusi=kdf
Otomi,\ Eastern\ Highland=otm
Delaware=del
Zenag=zeg
Nicaraguan\ Sign\ Language=ncs
Hemba=hem
Blaan,\ Sarangani=bps
Mubami=tsx
Nanubae=afk
Senoufo,\ Shempire=seb
Andio=bzb
Igwe=igw
Kitsai=kii
Kélé=keb
Moingi=mwz
Kusaghe=ksg
Ngandyera=nne
Tomyang=tmx
Min\ Bei\ Chinese=mnp
Turkmen=tk
Amarasi=aaz
Seneca=see
Gbaya-Bossangoa=gbp
Auvergnat=auv
Panamanian\ Sign\ Language=lsp
Yi,\ Central\ (Lolopo)=ycl
Sarawak\ Bisaya=bsd
San\ Miguel\ Creole\ French=scf
Mangareva=mrv
Colombian\ Sign\ Language=csn
Enggano=eno
Norwegian\ (Norway)=no
Manobo,\ Dibabawon=mbd
Suarmin=seo
Bedjond=bjv
Omok=omk
Joba=job
Yelmek=jel
Aka-Kede=akx
Ifugao,\ Batad=ifb
Yessan-Mayo=yss
Swedish\ Sign\ Language=swl
Mbo\ (Democratic\ Republic\ of\ Congo)=zmw
Kisi=kiz
Spanish\ (Argentina)=es
Kim\ Mun=mji
Amis,\ Nataoran=ais
Middle\ Low\ German=gml
Port\ Sandwich=psw
Bambili-Bambui=baw
Zapotec,\ Tilquiapan=zts
Wayoró=wyr
Phai=prt
Kisa=lks
Bauro=bxa
Quechua,\ Eastern\ Apurímac=qve
Haida=hai
Ahe=ahe
Saraveca=sar
Gaddang=gad
Baure=brg
Loniu=los
Nai=bio
Digo=dig
Varli=vav
Kryts=kry
Jola-Kasa=csk
Makuri\ Naga=jmn
Cineni=cie
Kire=geb
Wetamut=wwo
Wudu=wud
Qawasqar=sai
Patpatar=gfk
Agi=aif
Baniwa=bwi
Kereho-Uheng=xke
Kwakiutl=kwk
Mixtec,\ Tlazoyaltepec=mqh
Comanche=com
Manchu=mnc
Naga,\ Pochuri=npo
Pecheneg=xpc
Stod\ Bhoti=sbu
Abu’\ Arapesh=aah
Omaha-Ponca=oma
Haigwai=hgw
Qiang,\ Southern=qxs
Konomala=koa
Piedmontese=pms
Kataang=kgd
Elymian=xly
Alur=alz
Abé=aba
Hmar=hmr
Aluo=yna
Bosnian=bs
Baniva=bvv
Solos=sol
Maléku\ Jaíka=gut
Cavineña=cav
Sumbwa=suw
Sissano=sso
Church\ Slavic=cu
Tolomako=tlm
Dutton\ World\ Speedwords=dws
Meoswar=mvx
Mangole=mqc
Aer=aeq
Kaxararí=ktx
Lega-Mwenga=lgm
Zande\ (specific)=zne
Chhattisgarhi=hne
Yi,\ Wusa\ (Wumeng\ Nasu)=ywu
Zoque,\ Tabasco=zoq
Lobala=loq
Chonyi=coh
Vestinian=xvs
Towei=ttn
Acipa\ (Western)=awc
Moinba=mob
Pökoot=pko
Nsenga=nse
Agwagwune=yay
Nyahkur=cbn
Suena=sue
Waray\ (Philippines)=war
Sa'och=scq
Mansaka=msk
Maranao=mrw
Wumboko=bqm
Nambikuára,\ Southern=nab
Ubaghara=byc
Adi=adi
Triqui,\ Copala=trc
Waling=wly
Tamazight,\ Tidikelt=tia
Taita=dav
Temoq=tmo
Ravula=yea
Mazatec,\ Ayautla=vmy
Kurumba,\ Jennu=xuj
Sissala=sld
Bunu,\ Wunai=bwn
Maewo,\ Central=mwo
Iranun=ill
Kabwa=cwa
Mbunga=mgy
Magori=zgr
Narragansett=xnt
Ufim=ufi
Prussian=prg
Ma'di,\ Southern=snm
Galela=gbi
Ibani=iby
Itik=itx
Yinggarda=yia
Itawit=itv
Finnish\ Sign\ Language=fse
Gera=gew
Dibo=dio
Tutong\ 2=ttg
Tutong\ 1=ttx
Sinagen=siu
Abu=ado
Yurok=yur
Yue\ Chinese\ (Cantonese)=zh-yue
Aranama-Tamique=xrt
Monastic\ Sign\ Language=mzg
Bwaidoka=bwd
Kandas=kqw
Riung=riu
Western\ Farsi=pes
Rejang=rej
Kabras=lkb
Yali,\ Ninia=nlk
Lamma=lev
Mamuju=mqx
Morouas=mrp
Nobonob=gaw
Eshtehardi=esh
Yugambal=yub
Laomian=lwm
Hmong,\ Southern\ Qiandong=hms
Andai=afd
Kenyah,\ Tutoh=ttw
Dampelas=dms
Panawa=pwb
Icelandic\ (Iceland)=is
Iwaidja=ibd
Miarrã=xmi
Usan=wnu
Apurinã=apu
Wersing=kvw
Sisaala,\ Western=ssl
Hlersu=hle
Mixtec,\ Soyaltepec=vmq
Nkonya=nko
Ghale,\ Northern=ghh
Serui-Laut=seu
Yaeyama=rys
Gepo=ygp
Sonsorol=sov
Irarutu=irh
Tat,\ Muslim=ttt
Reyesano=rey
Bubia=bbx
Lihir=lih
Coptic=cop
Karen,\ Pwo\ Western=pwo
Serbian\ (Serbia)=sr
Makuráp=mpu
Baeggu=bvd
Mixtec,\ Santa\ Lucía\ Monteverde=mdv
Coquille=coq
Wampur=waz
Larteh=lar
Alor=aol
Illyrian=xil
Mbunda=mck
Koibal=zkb
Paipai=ppi
Dong,\ Northern=doc
Subanun,\ Lapuyan=laa
Sambal,\ Tinà=xsb
Wae\ Rana=wrx
Inupiatun,\ North\ Alaskan=esi
Sabaot=spy
Neyo=ney
Wapan=juk
Ngbee=jgb
Kaba\ Deme=kwg
Alta,\ Southern=agy
Slovakian\ Sign\ Language=svk
Ineseño=inz
Masana=mcn
Woccon=xwc
Manobo,\ Ata=atd
Hausa=ha
Kulisusu=vkl
Bunoge\ Dogon=dgb
Romanian\ (Romania)=ro
Lomwe,\ Malawi=lon
Mlomp=mlo
Taino=tnq
Ronji=roe
Dewoin=dee
Tasawaq=twq
Cara=cfd
Epie=epi
Dzùùngoo=dnn
Wumeng\ Yi=ywm
Zapotec,\ Santo\ Domingo\ Albarradas=zas
Tojolabal=toj
Riang\ (Myanmar)=ril
Kota\ (India)=kfe
Záparo=zro
Geme=geq
Magoma=gmx
One,\ Inebu=oin
Arifama-Miniafia=aai
Basa-Gumna=bsl
Yi,\ Western\ (Xishanba\ Lalo)=ywt
Bo-Rukul=mae
Mixtec,\ Huitepec=mxs
Roglai,\ Southern=rgs
Kopar=xop
Tamang,\ Southwestern=tsf
Classical\ Chinese=zh-classical
Modole=mqo
Khorasani\ Turkish=kmz
Ebira=igb
Yi,\ Limi=ylm
Caló=rmr
Gilaki=glk
Ziriya=zir
Wymysorys=wym
Zaiwa=atb
Mum=kqa
Shuswap=shs
Gela=nlg
German\ (Luxembourg)=de
Kota\ Marudu\ Tinagas=ktr
Bambam=ptu
Ngaing=nnf
Narrinyeri=nay
Wemale,\ South=tlw
Karitiâna=ktn
Nimanbur=nmp
Akuntsu=aqz
Kobiana=kcj
Ombo=oml
Jilim=jil
Seit-Kaitetu=hik
Kanum,\ Ngkâlmpw=kcd
Sagalla=tga
Sa'ban=snv
Malankuravan=mjo
Sartang=onp
Krongo=kgo
Quechua,\ Huaylas\ Ancash=qwh
Rampi=lje
Rarotongan=rar
Nyengo=nye
Ronga=rng
Geji=gji
Chorote,\ Iyojwa'ja=crt
Lower\ Sorbian=dsb
Ma\ (Democratic\ Republic\ of\ Congo)=msj
Barakai=baj
Lamet=lbn
Tembé=tqb
Tainae=ago
Breri=brq
Chipewyan=chp
Greek\ (Cappadocian)=cpg
Mangbetu=mdj
Yidiny=yii
Nakanai=nak
Nyangumarta=nna
Maku'a=lva
Jaya=jyy
Mru=mro
Duri=mvp
Chavacano=cbk
Nkongho=nkc
Huaulu=hud
Tibetan=bo
Dura=drq
Tarpia=tpf
Nete=net
Naga,\ Chang=nbc
Mixtec,\ Coatzospan=miz
Mazatec,\ Huautla=mau
Upper\ Necaxa\ Totonac=tku
Chinantec,\ Ojitlán=chj
Akaselem=aks
Torwali=trw
Krikati-Timbira=xri
Dusun,\ Sugut=kzs
Lingala=ln
Ahanta=aha
Aribwaung=ylu
Sininkere=skq
Yakut=sah
Bepour=bie
Panang=pcr
Aasáx=aas
Mfinu=zmf
Kela\ (Papua\ New\ Guinea)=kcl
Mbesa=zms
Makah=myh
Gbaya\ (Central\ African\ Republic)=gba
Quechua,\ Cusco=quz
Rohingya=rhg
Amundava=adw
Makaa=mcp
Atuence=atf
Jaruára=jap
Corsican=co
Didinga=did
Kewa,\ East=kjs
Orokaiva=ork
Jawe=jaz
Dongxiang=sce
Babatana=baa
Malay,\ Kupang=mkn
Ai-Cham=aih
Miraya\ Bikol=rbl
Ifugao,\ Tuwali=ifk
Mbere=mdt
Lawunuia=tgi
Malay,\ Balinese=mhp
Naga,\ Southern\ Rengma=nre
Lucumi=luq
Mpi=mpz
British\ Sign\ Language=bfi
Chin,\ Siyin=csy
International\ Sign=ils
Lezghian=lez
Caka=ckx
Sri\ Lankan\ Creole\ Malay=sci
Lamba=lam
Zia=zia
Kankanay,\ Northern=xnn
Para\ Naga=pzn
Moo=gwg
Kairak=ckr
Mon=mnw
Eton\ (Cameroon)=eto
Mok=mqt
Pannei=pnc
Urum=uum
Koy\ Sanjaq\ Surat=kqd
Arammba=stk
Puruborá=pur
Blackfoot=bla
Lamam=lmm
Guarequena=gae
Geez=gez
Alawa=alh
Bozo,\ Jenaama=bze
Arop-Sissano=aps
Duruwa=pci
Wapishana=wap
Lomwe=ngl
Dzando=dzn
Ulukwumi=ulb
Kui\ (Indonesia)=kvd
Pirahã=myp
Nubri=kte
Noiri=noi
Lengua=leg
Menya=mcr
Cora,\ Santa\ Teresa=cok
Haisla=has
Basketo=bst
Duna=duc
Inga,\ Jungle=inj
Bagusa=bqb
Chechen=ce
Tsotso=lto
Sakha=sah
Igbo=ig
Iteri=itr
Zenaga=zen
Nggwahyi=ngx
Rusyn=rue
Dumi=dus
Cafundo\ Creole=ccd
Tunica=tun
Bunun=bnn
Icelandic\ Sign\ Language=icl
Birifor,\ Southern=biv
Kumbaran=wkb
Duma=dma
Ngemba=nge
Jilbe=jie
Machinere=mpd
Mengen=mee
Kirikiri=kiy
Maritsauá=msp
Ibuoro=ibr
Acipa,\ Eastern=acp
Aringa=luc
Kulango,\ Bondoukou=kzc
Grebo,\ Northern=gbo
Hahon=hah
Obispeño=obi
Manobo,\ Cotabato=mta
Garifuna=cab
Zarphatic=zrp
Hermit=llf
Nauru=na
Duli=duz
Mendankwe-Nkwen=mfd
Jaru=ddj
Nend=anh
Molengue=bxc
Ginyanga=ayg
Apatani=apt
Quichua,\ Tena\ Lowland=quw
Chepang=cdm
Cantonese=zh-yue
Swabian=swg
Slavey,\ South=xsl
Jara=jaf
Quiché,\ Cunén=cun
Bété,\ Gagnoa=btg
Kuvi=kxv
Wuvulu-Aua=wuv
Bagupi=bpi
Duke=nke
Nemi=nem
Minz\ Zhuang=zgm
Northern\ Kalapuya=nrt
Masaba=myx
Gebe=gei
Neme=nex
German,\ Middle\ High\ (ca.1050-1500)=gmh
Luwian,\ Hieroglyphic=hlu
Muduapa=wiv
Natioro=nti
Sena,\ Malawi=swk
Ukrainian\ (Ukraine)=uk
Thaypan=typ
Mokole=mkl
Ayoreo=ayo
Alak=alk
Spanish\ (Guatemala)=es
Chimila=cbg
Ma'anyan=mhy
Sawknah=swn
Tamanaku=tmz
Male\ (Ethiopia)=mdy
Naga,\ Purum=puz
Meohang,\ Eastern=emg
Shehri=shv
Kutu=kdc
Taiap=gpn
Neku=nek
Awetí=awe
Itene=ite
Neko=nej
Karen,\ Geko=ghk
Wanggom=wng
Miu=mpo
Tawbuid,\ Western=twb
(none)=zxx
Banda-Ndélé=bfl
Saniyo-Hiyewe=sny
Skalvian=svx
Kambiwá=xbw
Lokoya=lky
Bahau=bhv
Duwet=gve
Tauya=tya
Butuanon=btw
Berinomo=bit
Kusu=ksv
Baham=bdw
Mixtec,\ Alacatlatzala=mim
Yavitero=yvt
Dutch\ Sign\ Language=dse
Martha's\ Vineyard\ Sign\ Language=mre
Zay=zwa
Yeniche=yec
Oirata=oia
Tawandê=xtw
Alyawarr=aly
Belanda\ Viri=bvi
Nauna=ncn
Rien=rie
Porohanon=prh
Jehai=jhi
Romanian=ro
Pimbwe=piw
Nadruvian=ndf
Tepehuan,\ Northern=ntp
Kuri=nbn
Malakhel=mld
Sakao=sku
Sakan=xsk
Tawara=twl
Sakam=skm
Oya'oya=oyy
Lelepa=lpa
Padoe=pdo
Ubang=uba
Kayan,\ Wahau=whu
Nisga'a=ncg
Tai\ Nüa=tdd
Vilela=vil
Aranadan=aaf
Gambera=gma
Galambu=glo
Ngasa=nsg
Clallam,\ Klallam=clm
om=hgm
Sranan\ Tongo=srn
Senoufo,\ Mamara=myk
Hyam=jab
Vaghat-Ya-Bijim-Legeri=bij
Southern\ Zhuang=ccy
Djinang=dji
Teke-Kukuya=kkw
Caac=msq
Xiandao=xia
Eggon=ego
Ayi\ (China)=ayx
Yine=pib
Morori=mok
Beti\ (Côte\ d'Ivoire)=eot
Mer=mnu
Zhire=zhi
Jola-Fonyi=dyo
Judeo-Berber=jbe
Manobo,\ Matigsalug=mbt
Makhuwa-Moniga=mhm
Kupa=kug
Seko\ Tengah=sko
Haruku=hrk
Mixtec,\ Pinotepa\ Nacional=mio
Kalami=gwc
Karen,\ Pwo\ Eastern=kjp
Mundabli=boe
Bilaspuri=kfs
Chin,\ Khumi=cnk
Mea=meg
Krumen,\ Plapo=ktj
Kuot=kto
Zapotec,\ San\ Pedro\ Quiatoni=zpf
Persian,\ Old\ (ca.600-400\ B.C.)=peo
Zemba=dhm
Wampar=lbq
Duwai=dbp
Duruma=dug
Krumen,\ Tepo=ted
Lelemi=lef
Zapotec,\ Ocotlán=zac
Batui=zbt
Urarina=ura
Atta\ (Faire)=azt
Bisorio=bir
Mekwei=msf
Zapotec,\ Tabaa=zat
Estonian\ Sign\ Language=eso
Yinchia=yin
Idoma=idu
Yakha=ybh
Latvian\ Sign\ Language=lsl
Hunnic=xhc
Scythian=xsc
Khua=xhv
Gende=gaf
Serbian\ (Montenegro)=sr
Senoufo,\ Syenara=shz
Kuni=kse
Bulgarian\ (Bulgaria)=bg
Vietnamese=vi
Kung=kfl
Nong\ Zhuang=zhn
Binumarien=bjr
Mpotovoro=mvt
Awera=awr
Banda-Mbrès=bqk
Urim=uri
Taulil=tuh
Tause=tad
Sardinian=sc
Atta\ (Pudtol)=atp
Kwomtari=kwo
Adyghe=ady
Dubu=dmu
Dani,\ Western=dnw
Bulgarian=bg
Atohwaim=aqm
Temiar=tea
Mbula-Bwazza=mbu
Obulom=obu
Nadëb=mbj
Wemale,\ North=weo
Sanapaná=sap
Guibian\ Zhuang=zgn
Minaean=inm
Darwazi=drw
Camling=rab
Iquito=iqu
Scottish\ Gaelic=gd
Saparua=spr
Semendo=sdd
Kaulong=pss
Zapotec,\ El\ Alto=zpp
Yi,\ Miqie=yiq
Jamaican\ Sign\ Language=jls
Bali\ Sign\ Language=bqy
Mbe=mfo
Duau=dva
Arabic\ (Syria)=ar
Mba=mfc
Yuqui=yuq
Portuguese\ Sign\ Language=psr
Kanggape=igm
Tawala=tbo
Dida,\ Yocoboué=gud
Kula=tpg
Mal=mlf
Akwa=akw
Marrucinian=umc
Tonga\ (Zambia)=toi
Mae=mme
Asuriní,\ Xingú=asn
Opata=opt
Selepet=spl
Biloxi=bll
Tuxináwa=tux
Maa=cma
Ngamo=nbh
Bamali=bbq
Ciwogai=tgd
Purari=iar
Argobba=agj
Arára,\ Pará=aap
Menka=mea
Dengese=dez
Kuruáya=kyr
Feroge=fer
Tartessian=txr
Namosi-Naitasiri-Serua=bwb
Karen,\ Geba=kvq
Adygei=ady
Semimi=etz
Papasena=pas
Warapu=wra
Tachawit=shy
French,\ Old\ (842-Ca.1400)=fro
Bungu=wun
Dimili=zza
Tichurong=tcn
Dagaari\ Dioula=dgd
Friulian=fur
Kanoé=kxo
Yambes=ymb
Hmong,\ Chonganjiang=hmj
Akum=aku
Kamula=xla
Mashi\ (Zambia)=mho
Arafundi=arf
Ngala=nud
Penang\ Sign\ Language=psg
Moken=mwt
Hlai=lic
Interlingua\ (IALA)=ia
Alago=ala
Kagoro=xkg
Lower\ Pokomo=poj
Arabic\ (Egyptian)=arz
Kansa=ksk
Kewa,\ West=kew
Turks\ And\ Caicos\ Creole\ English=tch
Zapotec,\ Rincón=zar
Lehali=tql
Siroi=ssd
Papora=ppu
Selayar=sly
Buamu=box
Small\ Flowery\ Miao=sfm
Seberuang=sbx
Hill\ Mari=mrj
Tumshuqese=xtq
Bainouk-Gunyaamolo=bcz
Tanimbili=tbe
Kuwaataay=cwt
Sensi=sni
Somali=so
Libinza=liz
Leyigha=ayi
Hiri\ Motu=ho
Zapotec,\ Ozolotepec=zao
Lengola=lej
Urdu=ur
Lewo\ Eleng=lwe
Buduma=bdm
Lepki=lpe
Gozarkhani=goz
Naga,\ Maram=nma
Maramba=myd
Tiranige\ Diga\ Dogon=tde
Ngaju=nij
Konkani\ (specific)=knn
Gowro=gwf
Kobon=kpw
Kobol=kgu
Ketangalan=kae
Lozi=loz
Oyda=oyd
Pak-Tong=pkg
Yakan=yka
Yawarawarga=yww
Wutunhua=wuh
Mawes=mgk
Samo,\ Maya=sym
Yangbye=ybd
Pamlico=pmk
Kalinga,\ Madukayang=kmd
Amami-Oshima,\ Southern=ams
Yug=yug
Mixtec,\ Tututepec=mtu
Budukh=bdk
Stieng,\ Budeh=stt
Hanoi\ Sign\ Language=hab
Malay,\ Manado=xmm
Thayore=thd
Curonian=xcu
Valencian\ Sign\ Language=vsv
Fulniô=fun
Khmu=kjg
Tagal\ Murut=mvv
Lematang=lmt
Bareli,\ Rathwi=bgd
Cakchiquel,\ Southern=ckf
Romanian,\ Megleno=ruq
Eitiep=eit
Lombard=lmo
Ukpet-Ehom=akd
Tuamotuan=pmt
Lishán\ Didán=trg
Old\ Kentish\ Sign\ Language=okl
Pohnpeian=pon
Vatrata=vlr
Itneg,\ Maeng=itt
Ventureño=veo
Khmer,\ Northern=kxm
Gadaba,\ Bodo=gbj
Orejón=ore
Mashco\ Piro=cuj
Kaba\ Na=kwv
Urat=urt
Tai\ Long=thi
Mankanya=knf
Kelabit=kzi
Old\ Chinese=och
Lisabata-Nuniali=lcs
Anaang=anw
Dhao=nfa
Russian=ru
Bamunka=bvm
Mazagway=dkx
Tuscarora=tus
Aka-Kol=aky
Haruai=tmd
Juwal=mwb
Saint\ Lucian\ Creole\ French=acf
Bagri=bgq
Buru\ (Nigeria)=bqw
Lowa=loy
Carib=car
Lampung=ljp
Mandobo\ Bawah=bwp
Luwati=luv
Lamatuka=lmq
Nahuatl,\ Tetelcingo=nhg
Gbe,\ Western\ Xwla=xwl
Moi\ (Indonesia)=mxn
Akpa=akf
Gula'alaa=gmb
Saudi\ Arabian\ Sign\ Language=sdl
Lombo=loo
Sangisari=sgr
Bukusu=bxk
Yi,\ Eshan-Xinping\ (Northern\ Nisu)=yiv
Spanish\ (Castilian)=es
Alaba=alw
Sami,\ Pite=sje
Lombi=lmi
Kagoma=kdm
Mahican=mjy
Sanglechi-Ishkashimi=sgl
Aymara\ (Central)=ayr
Molima=mox
Belarusian\ (taraškevica)=be-x-old
Chepya=ycp
Cakchiquel,\ Central=cak
Júma=jua
Bunak=bfn
Gwere=gwr
Elepi=ele
Callawalla=caw
Olulumo-Ikom=iko
Majhi=mjz
Triqui,\ Chicahuaxtla=trs
Slavey,\ North=scs
Lingua\ Franca=pml
Mawan=mcz
Tarifit=rif
Pame,\ Northern=pmq
Tày\ Sa\ Pa=tys
Mawak=mjj
Loun=lox
Topoiyo=toy
Ikoma=ntk
Mwan=moa
Kalmyk=xal
Ralte=ral
Ontenu=ont
Bakung\ Kenyah=boc
Batak\ Toba=bbc
Kabalai=kvf
Mari\ (East\ Sepik\ Province)=mbx
Awa-Cuaiquer=kwi
Tzotzil,\ Chamula=tzc
Agta,\ Remontado=agv
Malagasy,\ Tanosy=txy
Birhor=biy
Runa=rna
Datooga=tcc
Vehes=val
Mangala=mem
Ehueun=ehu
Kubu=kvb
Avá-Canoeiro=avv
Gowli=gok
Rumu=klq
Nuaulu,\ South=nxl
Gondi,\ Northern=gno
Pushto=ps
Kubo=jko
Lote=uvl
Sinaugoro=snc
North\ Picene=nrp
Hmong,\ Northern\ Qiandong=hea
Lalia=lal
Arabic\ (Moroccan)=ary
Kubi=kof
Kalapuya,\ Southern=sxk
Kazukuru=kzk
Aribwatsa=laz
Kube=kgf
Yoy=yoy
Thuri=thu
Ruma=ruz
Ampanang=apg
Lamnso'=lns
Djauan=djn
Yos=yos
Loarki=lrk
Yom=pil
Uruava=urv
Old\ Irish=sga
Kanju=kbe
Gunwinggu=gup
Serbian\ (Serbia\ and\ Montenegro)=sr
Otomi,\ Mezquital=ote
Talise=tlr
Kuan=uan
Naga,\ Nocte=njb
Kanum,\ Smärky=kxq
Muko-Muko=vmo
Ruli=ruc
Umeda=upi
Faliscan=xfa
Zapotec,\ Yalálag=zpu
Bierebo=bnk
Luo=luw
Tambotalo=tls
Eleme=elm
Lui=lba
Bwatoo=bwa
Kerek=krk
Gbati-ri=gti
Kokota=kkk
Taroko=trv
Aragonese=an
Gweno=gwe
Puragi=pru
Indus\ Valley\ Language=xiv
Albanian\ (Albania)=sq
Ndoola=ndr
Tawbuid,\ Eastern=bnj
Slovak=sk
Kahayan=xah
Twents=twd
Buriat=bxr
Pacahuara=pcp
Kalinga,\ Lubuagan=knb
Sri\ Lankan\ Sign\ Language=sqs
Nama\ (Papua\ New\ Guinea)=nmx
Mandaya,\ Cataelano=mst
Zapotec,\ Cajonos=zad
Achumawi=acv
Ndebele,\ South=nr
Ndut=ndv
Sechelt=sec
Bosngun=bqs
Ndun=nfd
Balochi,\ Western=bgn
Miyobe=soy
Batek=btq
Manobo,\ Sarangani=mbs
Korean,\ Old\ (3rd\ -\ 9th\ cent.)=oko
Awbono=awh
Mosiro=mwy
Kacipo-Balesi=koe
Goemai=ank
Khayo=lko
Tubar=tbu
Zokhuo=yzk
Lopi=lov
Frisian,\ Old=ofs
Lorung,\ Southern=lrr
Lopa=lop
Guanyinqiao=jiq
Chesu=ych
Kaingáng=kgp
Tanana,\ Lower=taa
Kanga=kcp
Ligbi=lig
Gothic=got
Parbate,\ Eastern=kif
Czech\ Sign\ Language=cse
Gwich´in=gwi
Romany=rom
Sengo=spk
Chatino,\ Zacatepec=ctz
Phimbi=phm
Meohang,\ Western=raf
Tlalitzlipa\ Nahuatl=nhj
Banda,\ Mid-Southern=bjo
Bhojpuri=bho
Gamkonora=gak
Korlai\ Creole\ Portuguese=vkp
Wayana=way
Mada\ (Cameroon)=mxu
Oromo,\ West\ Central=gaz
Hunde=hke
Akha=ahk
Usarufa=usa
Kerak=hhr
Modang=mxd
Ute-Southern\ Paiute=ute
Lyélé=lee
Saaroa=sxr
Selaru=slu
Egypt\ Sign\ Language=esl
Karkar-Yuri=yuj
Kutto=kpa
Kiliwa=klb
Ruga=ruh
Romani,\ Vlax=rmy
Senoufo,\ Djimini=dyi
Khalaj,\ Turkic=klj
Yis=yis
Pardhi=pcl
Kalaktang\ Monpa=kkf
Pray\ 3=pry
Palatinate\ German=pfl
Babine=bcr
Yil=yll
Umbrian=xum
Savosavo=svs
Pitta\ Pitta=pit
Manobo,\ Ilianen=mbi
Ardhamāgadhī\ Prākrit=pka
Bontoc,\ Central=bnc
Georgian,\ Old=oge
Maiwala=mum
Varhadi-Nagpuri=vah
Duvle=duv
Lou=loj
Sened=sds
Batak=bya
Palaung,\ Pale=pce
Kande=kbs
Loo=ldo
Lom=mfb
Guinean\ Sign\ Language=gus
Naga,\ Kharam=kfw
Kyrgyz=ky
Tobian=tox
Huichol=hch
Khao=xao
Nahuatl,\ Tenango=nhi
Nyeng=nfg
Lolo=llb
Rombo=rof
Chocangacakha=cgk
Belgian\ Sign\ Language=bvs
Havasupai-Walapai-Yavapai=yuf
Shumcho=scu
Alladian=ald
Hlepho\ Phowa=yhl
Akeu=aeu
Lole=llg
Mosina=msn
Subiya=sbs
Lola=lcd
Sowa=sww
Ughele=uge
Akei=tsr
Koiali,\ Mountain=kpx
Àhàn=ahn
Baluchi=bal
Nyemba=nba
Marghi\ Central=mrt
Mosimo=mqv
Loko=lok
Burusu=bqr
Romam=rmx
French,\ Middle\ (ca.1400-1600)=frm
Sawai=szw
Kele\ (Democratic\ Republic\ of\ Congo)=khy
Sô=sss
Petjo=pey
Guajajára=gub
Wu=wuu
Anfillo=myo
Otomi,\ Texcatepec=otx
Sacapulteco=quv
Qimant=ahg
Ndom=nqm
Ngarinman=nbj
Munkip=mpv
Nyâlayu=yly
Sisaala,\ Tumulung=sil
Ndoe=nbb
Bentong=bnu
Salt-Yui=sll
Batuley=bay
Wa=wbm
Orowe=bpk
German,\ Colonia\ Tovar=gct
Cakchiquel,\ Western=ckw
Kokola=kzn
Fali\ Of\ Baissa=fah
Khasi=kha
Kenuzi-Dongola=kzh
Tongwe=tny
Puelche=pue
Northern\ Nambikuára=mbg
Bambassi=myf
Batak\ Dairi=btd
Kowaki=xow
Yangum\ Gel=ygl
Kháng=kjm
Ketengban=xte
Kazakh=kk
Kara\ (Korea)=zra
Wambon=wms
Fipa=fip
Simeulue=smr
Yei=jei
Dahalo=dal
Nenets=yrk
Bete=byf
Toura\ (Papua\ New\ Guinea)=don
Quapaw=qua
Ghomara=gho
Zapotec,\ Mixtepec=zpm
Naga,\ Lotha=njh
Tubarão=tba
Bicolano,\ Northern\ Catanduanes=cts
Abishira=ash
Garasia,\ Adiwasi=gas
Magahi=mag
Yulu=yul
Senoufo,\ Supyire=spp
Katingan=kxg
Bundeli=bns
Samo,\ Matya=stj
Tu=mjg
Malagasy,\ Bara=bhr
Koropó=xxr
Nungu=rin
Ghale,\ Kutang=ght
Akan=ak
To=toz
Hunzib=huz
Bilbil=brz
Yokuts=yok
Palawano,\ Central=plc
Quechua,\ North\ Bolivian=qul
Gweda=grw
Bozo,\ Tiéyaxo=boz
Mixtec,\ Santa\ María\ Zacatepec=mza
Awyi=auw
Logo=log
Nahuatl,\ Temascaltepec=nhv
Maringarr=zmt
Miya=mkf
Guiqiong=gqi
Tboli=tbl
Quechua,\ Sihuas\ Ancash=qws
Sora=srb
Yuki=yuk
Fulfulde,\ Maasina=ffm
Bera=brf
Selako=skl
Bhatola=btl
Shuadit=sdt
Hmong,\ Central\ Mashan=hmm
Baha\ Buyang=yha
Susquehannock=sqn
Temuan=tmw
Balochi,\ Southern=bcc
Kurmukar=kfv
Sa=sax
Gaina=gcn
English\ (Ireland)=en
Snohomish=sno
Boloki=bkt
Yeskwa=yes
Dusun,\ Tempasuk=tdu
Idaté=idt
Awa\ (China)=vwa
Oriya,\ Adivasi=ort
Palaung,\ Rumai=rbb
Yangben=yav
Uduk=udu
Nyaturu=rim
Bandjigali=bjd
Wali\ (Ghana)=wlx
Sangkong=sgk
Yao=yao
Makolkol=zmh
Chimariko=cid
Miwa=vmi
Mnong,\ Central=cmo
Blablanga=blp
Wirangu=wiw
Talieng=tdf
Abnaki\ (Eastern)=aaq
Enya=gey
Khana=ogo
Kemezung=dmo
Kyenga=tye
Pacoh=pac
Boruca=brn
Mixed\ Great\ Andamanese=gac
Tunni=tqq
Anglo-Saxon=ang
Chrau=crw
Lü=khb
Wu\ Chinese=wuu
Classical\ Newari=nwc
Sepedi=nso
Marithiel=mfr
Kohumono=bcs
Yi,\ Southern\ Lolopho=ysp
Dinka,\ Southeastern=dks
Provençal=prv
Awun=aww
Pe=pai
Rawang=raw
Romani,\ Kalo\ Finnish=rmf
Thakali=ths
Fulfulde\ (Adamawa)=fub
Gimi\ (West\ New\ Britain)=gip
Oy=oyb
Wannu=jub
Haitian\ Vodoun\ Culture\ Language=hvc
Kwini=gww
Beng=nhb
Singapore\ Sign\ Language=sls
Gula\ (Central\ African\ Republic)=kcm
Hatam=had
Kosraean=kos
Yugh=yuu
Malay,\ Pattani=mfa
Luimbi=lum
English\ (South\ Africa)=en
Od=odk
Nefamese=nef
Paiute,\ Northern=pao
Maridjabin=zmj
Kanjari=kft
Kokoda=xod
Ramoaaina=rai
Lobi=lob
Median=xme
Turkish,\ Ottoman\ (1500-1928)=ota
Makhuwa-Marrevone=xmc
Laurentian=lre
Lembena=leq
Mediak=mwx
Zapotec,\ Texmelucan=zpz
Tswana=tn
Nuaulu,\ North=nni
Koroni=xkq
Papel=pbo
Karipúna\ Creole\ French=kmv
Hausa\ Sign\ Language=hsl
Na=nbt
Twendi=twn
Chin,\ Paite=pck
Masbatenyo=msb
Barapasi=brp
Soli=sby
Morawa=mze
Kangean=kkv
Zoque,\ Rayón=zor
Darling=drl
Brem=buq
Babuza=bzg
Popoluca,\ Texistepec=poq
Konni=kma
Maxakalí=mbl
Okobo=okb
Kamwe=hig
Oromo=om
Limburgish,\ Limburgan=li
Gavar=gou
Miri=mrg
Luri,\ Southern=luz
Mire=mvh
Fijian\ Hindustani=hif
Puwa\ Yi=ypw
Yambeta=yat
Mongolian\ Sign\ Language=msr
Shwai=shw
Dagara,\ Northern=dgi
Eteocretan=ecr
Chinook=chh
Bayungu=bxj
Mesqan=mvz
Kom\ (Cameroon)=bkm
Ambrym,\ Southeast=tvk
Pattani=lae
Midob=mei
Tai\ Ya=cuu
Vidunda=vid
Baga\ Sobané=bsv
Dera\ (Indonesia)=kbv
Ontong\ Java=ojv
Bassa=bsq
Tunia=tug
Armazic=xrm
Kenswei\ Nsei=ndb
Principense=pre
Chorotega=cjr
Carolina\ Algonquian=crr
Adele=ade
Laz=lzz
Iu\ Mien=ium
Sepa\ (Papua\ New\ Guinea)=spe
Zan\ Gula=zna
Lau=llu
Sangu\ (Tanzania)=sbp
Ko=fuj
Wanji=wbi
Beja=bej
Lao=lo
Kurdish,\ Central=ckb
Kutep=kub
Oroko=bdu
Yali,\ Angguruk=yli
Papavô=ppv
Lak=lbe
Kwanja=knp
Avestan=ae
Yi,\ Eastern\ Lalu=yit
Ndebele,\ North=nd
Atemble=ate
Emiliano-Romagnolo=eml
Yir\ Yoront=yiy
Omagua=omg
Dhurga=dhu
Tingal=tie
Carabayo=cby
Dogosé=dos
Ju=ktz
Quechua,\ Huaylla\ Wanca=qvw
Konjo,\ Coastal=kjc
Irigwe=iri
Dori'o=dor
Pukapuka=pkp
Tambora=xxt
Papar=dpp
Karen,\ Yintale=kvy
Tepehua,\ Pisaflores=tpp
Volscian=xvo
Ts'ün-Lao=tsl
Miwok,\ Northern\ Sierra=nsq
So\ (Democratic\ Republic\ of\ Congo)=soc
Biafada=bif
Chin,\ Bawm=bgr
Ndau=ndc
Maninkakan,\ Kita=mwk
Bambara=bm
Mannan=mjv
Konjo=koo
Sea\ Island\ Creole\ English=gul
Ir=irr
Arabic\ (Hadrami)=ayh
Njerep=njr
Ndam=ndm
Balochi,\ Eastern=bgp
Ndai=gke
Kumukio=kuo
Ik=ikx
Braj=bra
Okolod=kqv
Hungana=hum
Harzani=hrz
Ormuri=oru
Raeto\ Romance=rm
Isu\ (Menchum\ Division)=isu
Daonda=dnd
Gidar=gid
Spanish=es
Hu=huo
Soga=xog
Thai\ Song=soa
Ho=hoc
Bondei=bou
Tunen=baz
Bugawac=buk
Domung=dev
Kwanga=kwj
Wanga=lwg
Sotho,\ Southern=st
Mimi=miv
Bafut=bfd
Ha=haq
Lusitanian=xls
West\ Albay\ Bikol=fbl
Oroha=ora
Shipibo-Conibo=shp
Kwaami=ksq
Timugon\ Murut=tih
Satawalese=stw
Kwerba=kwe
Mailu=mgu
Waama=wwa
Persian=prp
Namakura=nmk
Karen,\ Yinbaw=kvu
Nyankole=nyn
Ngarinyin=ung
Kashaya=kju
Tiwi=tiw
Yiddish=yi
Ga=gaa
Jahanka=jad
Libyan\ Sign\ Language=lbs
Tiwa=lax
Dogoso=dgs
Kasanga=ccj
Kongo=kg
Suganga=sug
Pyu\ (Myanmar)=pyx
Basa-Gurmana=buj
Borôro=bor
Sivandi=siy
Yerukula=yeu
Quileute=qui
Evant=bzz
Bicolano,\ Albay=bhk
Mbembe,\ Cross\ River=mfn
Karamojong=kdj
Keres,\ Eastern=kee
Taveta=tvs
Bai,\ Southern=bfs
Ngundu=nue
Mayeka=myc
Arabic\ (Lebanon)=ar
Baangi=bqx
Gbanziri=gbg
Ngundi=ndn
Enets,\ Tundra=enh
Binji=bpj
Kensiu=kns
Dadiya=dbd
En=enc
Pokangá=pok
Shumashti=sts
Mixtec,\ Southeastern\ Nochixtlán=mxy
Wanda=wbh
Baldemu=bdn
Comecrudo=xcm
Bactrian=xbc
Yawanawa=ywn
Naga\ Pidgin=nag
Pomo,\ Southeastern=pom
Mapoyo=mcg
Silt'e=xst
Occitan=oc
Ingrian=izh
Mauwake=mhl
Agatu=agc
Dogri\ (specific)=dgo
Xârâcùù=ane
Mnong,\ Southern=mnn
Thopho=ytp
Parbate,\ Western=kjl
Bicolano,\ Central=bcl
Halang=hal
Tadaksahak=dsq
Trinitario=trn
Kagate=syw
Ndengereko=ndg
Kaili,\ Unde=unz
Farefare=gur
Pochutec=xpo
Kadiwéu=kbc
Nguôn=nuo
Tharu,\ Rana=thr
Humla=hut
Bankagooma=bxw
Anambé=aan
Muthuvan=muv
Nung\ (Viet\ Nam)=nut
Masimasi=ism
Gurgula=ggg
Asmat,\ Casuarina\ Coast=asc
Malasanga=mqz
Tita=tdq
Guaraní,\ Eastern\ Bolivian=gui
Gilyak=niv
Chimakum=cmk
Tharaka=thk
Albanian\ (Arvanitika)=aat
Latgalian=ltg
Zome=zom
Bebe=bzv
Wariyangga=wri
Bantik=bnq
Beba=bfp
Mixtec,\ Juxtlahuaca=vmc
Chitimacha=ctm
Muratayak=asx
Yurutí=yui
Konda=knd
Oroch=oac
Dhundari=dhd
Lolak=llq
Cakchiquel,\ Eastern=cke
Pangseng=pgs
Guana\ (Brazil)=gqn
Kauwera=xau
Ntcham=bud
Quechua,\ Cajamarca=qvc
Bu=jid
Wanap=wnp
Tagoi=tag
Haryanvi=bgc
Kham,\ Sheshi=kip
Asmat,\ North=nks
Tsakhur=tkr
Bungain=but
Karen,\ Brek=kvl
Providencia\ Sign\ Language=prz
Tiri=cir
Interlingue=ie
Romani,\ Baltic=rml
Enim=eni
Yi,\ Ache=yif
Kwa=kwb
Min\ Nan\ Chinese=nan
Lingarak=lgk
Tira=tic
Antakarinya=ant
Ninzo=nin
Natchez=ncz
Au=avt
Awjilah=auj
Kugbo=kes
Aka-Kora=ack
Nyawaygi=nyt
As=asz
Ajië=aji
Kpessi=kef
Asháninka=cni
Kuku-Uwanh=uwa
Kalanadi=wkl
Hittite,\ Neo-=nei
Moldova\ Sign\ Language=vsi
Ak=akq
Beti\ (Cameroon)=btb
Notsi=ncf
Athpariya=aph
Miyako=mvi
Mawchi=mke
Miriwung=mep
Alamblak=amp
Biali=beh
Tongan=to
Nukuini=nuc
To'abaita=mlu
Oneida=one
Ibibio=ibb
Kayah,\ Eastern=eky
Westphalien=wep
Kuy=kdt
Lakha=lkh
Glio-Oubi=oub
Kur=kuv
Konai=kxw
Kuo=xuo
Saliba=sbe
Kuk=kfn
Furu=fuu
Pendau=ums
Notre=bly
Armenian=hy
Kua=tyu
Baga\ Sitemu=bsp
Moraid=msg
Attié=ati
Judeo-Georgian=jge
Enga=enq
Baatonum=bba
Cuicatec,\ Teutila=cut
Tingui-Boto=tgv
Tamagario=tcg
Gurmana=gvm
Vangunu=mpr
Kabardian\ Circassian=kbd
Niellim=nie
Miship=mjs
Bushoong=buf
Guadeloupean\ Creole\ French=gcf
Seselwa\ Creole\ French=crs
Aquitanian=xaq
Moabite=obm
Humene=huf
Duhwa=kbz
Gascon=gsc
Simbari=smb
Laos\ Sign\ Language=lso
Chantyal=chx
Duupa=dae
Xukurú=xoo
Totonac,\ Highland=tos
Sakata=skt
Yemsa=jnj
Worimi=kda
Gbe,\ Weme=wem
Subtiaba=sut
Chinese\ Pidgin\ English=cpi
Pero=pip
Gone\ Dau=goo
Iraya=iry
Ga'anda=gqa
Kemberano=bzp
Nahuatl,\ Huaxcaleca=nhq
Barrow\ Point=bpt
Ibatan=ivb
Endo=enb
Lave=brb
Tima=tms
Bogan=bgh
Hmong,\ Northern\ Guiyang=huj
Japanese\ Sign\ Language=jsl
Muzi=ymz
Ende=end
Chin,\ Thado=tcz
Ubykh=uby
Occitan\ (post\ 1500)=oc
Korowai=khe
Osing=osi
Ngaanyatjarra=ntj
Maslam=msv
Songoora=sod
Awar=aya
Birgit=btf
Mixtec,\ Sinicahua=xti
Mian=mpt
Awak=awo
Bajau,\ West\ Coast=bdr
Baga\ Manduri=bmd
Lushootseed=lut
Aneme\ Wake=aby
Makonde=kde
Banda,\ South\ Central=lnl
Tulehu=tlu
Laua=luf
Biage=bdf
Nyakyusa-Ngonde=nyy
Tatar=tt
Latu=ltu
Muya=mvm
Bafia=ksf
North\ Korowai=krg
Yassic=ysc
Achí,\ Cubulco=acc
Bukharic=bhh
Siliput=mkc
Tunisian\ Sign\ Language=tse
Ternate=tft
Kumbainggar=kgs
Nkangala=nkn
Harauti=hoj
Arabic\ (Jordan)=ar
Lachirioag\ Zapotec=ztc
Zapotec,\ Miahuatlán=zam
Panytyima=pnw
Basay=byq
Gbaya-Bozoum=gbq
Vanimo=vam
Duriankere=dbn
Kaninuwa=wat
Tibea=ngy
Basap=bdb
Dalmatian=dlm
Ndonga=ng
Ogbronuagum=ogu
Orokolo=oro
Mombum=mso
Yerakai=yra
Kol=ekl
Aramaic,\ Old=oar
Assamese=as
Koi=kkt
Lasi=lss
Songhai,\ Koyraboro\ Senni=ses
Tombulu=tom
Muong=mtq
Chontal,\ Tabasco=chf
Keder=kdy
Bookan=bnb
Tsetsaut=txc
Laru=lan
Tagargrent=oua
Judeo-Arabic=jrb
Maria,\ Dandami=daq
Malay,\ North\ Moluccan=max
Laro=lro
Atsahuaca=atc
Kokata=ktd
Caddo=cad
Javanese,\ Caribbean=jvn
Aymara=ay
Cree\ (Moose)=crm
Lari=lrl
Sama,\ Central=sml
Rennell-Belona=mnv
Zapotec,\ Southeastern\ Ixtlán=zpd
Dinka,\ Southwestern=dik
Simbali=smg
English\ (Canada)=en
Bhalay=bhx
Cruzeño=crz
Meriam=ulk
Owiniga=owi
Kanasi=soq
Surajpuri=sjp
Fulfulde\ (Nigerian)=fuv
Anasi=bpo
Norwegian\ (Norway,Nynorsk)=no
Gahri=bfu
Duduela=duk
Yuchi=yuc
Kadazan,\ Klias\ River=kqt
Mondropolon=npn
Kodagu=kfa
Tai\ Mène=tmp
Chibcha=chb
Mal\ Paharia=mkb
Kamas=xas
Kamar=keq
Mixtec,\ Ixtayutla=vmj
Tai\ Do=tyj
Southeastern\ Puebla\ Nahuatl=npl
Nyamwanga=mwn
Japanese\ (Japan)=ja
Bahamas\ Creole\ English=bah
Pela=bxd
Bassossi=bsi
Yidgha=ydg
Akebu=keu
Mutu=tuc
Salumá=slj
Hasha=ybj
Iha\ Based\ Pidgin=ihb
Birifor,\ Malba=bfo
Itneg,\ Banao=bjx
Siamou=sif
Yoruba=yo
Lorang=lrn
Semai=sea
Tungag=lcm
Teke-Tyee=tyx
Lasalimu=llm
Lundayeh=lnd
Bulgebi=bmp
Uzbek,\ Northern=uzn
Tày=tyz
Cakchiquel,\ South\ Central=ckd
Limbum=lmp
Chinantec,\ Valle\ Nacional=cvn
Standard\ Malay=zsm
Tagbu=tbm
Iraqw=irk
Punan\ Tubu=puj
Musi=mui
Sorbian,\ Lower=dsb
Kasseng=kgc
Hindi=hi
Dusner=dsn
Asmat\ (Yaosakor)=asy
Nafaanra=nfr
Kurumba=kfi
Bangba=bbe
Pijin=pis
Himarimã=hir
Bahnar=bdq
Avatime=avn
Tela-Masbuar=tvm
Saya=say
Bishnupriya\ Manipuri=bpy
Salish,\ Straits=str
Lemolang=ley
Lamu=llh
Zapotec,\ Ayoquesco=zaf
Kis=kis
Algerian\ Sign\ Language=asp
Wailapa=wlr
Kim=kia
Chin,\ Asho=csh
Bedoanas=bed
Mono\ (Solomon\ Islands)=mte
Ponosakan=pns
Arabic\ (Mesopotamian)=acm
Lame=bma
Shina=scl
Kalabra=kzz
Mogholi=mhj
German=de
Carib,\ Island=crb
Sebuyau=snb
Komso=kxc
Tuxá=tud
Veddah=ved
Rongpo=rnp
Emberá-Chamí=cmi
Sawi=saw
Numee=kdk
Chakma=ccp
Tewa\ (USA)=tew
Khe=kqg
Finnish\ (Kven)=fkv
Xam=xam
Lala=nrz
Karipuná=kuq
Iyayu=iya
Vaiphei=vap
Muinane=bmr
Quiripi=qyp
Gresi=grs
Gugadj=ggd
Weri=wer
Wongo=won
Were=wei
Kungarakany=ggk
Koromira=kqj
Yonggom=yon
Spiti\ Bhoti=spt
Mnong,\ Eastern=mng
Dyugun=dyd
Udmurt=udm
Laki=lki
Savi=sdg
Mixtec,\ Southern\ Puebla=mit
Chin,\ Tedim=ctd
Breton=br
Serbo-Croatian=sh
Abanyom=abm
Waiwai=waw
Tiwa,\ Northern=twf
Tegali=ras
Kag-Fer-Jiir-Koor-Ror-Us-Zuksun=gel
Tupuri=tui
Yau\ (Sandaun\ Province)=yyu
Tippera=tpe
Lega-Shabunda=lea
Gaulish,\ Cisalpine=xcg
Pawnee=paw
Malaccan\ Creole\ Portuguese=mcm
Barwe=bwg
Zapotec,\ Amatlán=zpo
Sauk=skc
Shiki=gua
Pangasinan=pag
Jamaican\ Creole\ English=jam
Kabola=klz
Hértevin=hrt
Maung=mph
Quechua,\ Lambayeque=quf
Balanta-Kentohe=ble
Pennsylvania\ German=pdc
Nafri=nxx
Ayere=aye
Old\ Persian=ope
Ket=ket
Kayardild=gyd
Muna=mnb
Melpa=med
Bwamu,\ Cwi=bwy
Ede\ Cabe=cbj
Somyev=kgt
Ghanongga=ghn
Sapé=spc
Resígaro=rgr
Mairasi=zrs
Moresada=msx
Kei=kei
Pame,\ Central=pbs
Rungwa=rnw
Mixtec,\ Northwest\ Oaxaca=mxa
Pashto,\ Northern=pbu
Omotik=omt
Muyang=muy
Wikalkan=wik
Gunya=gyy
Wailaki=wlk
Lahu=lhu
Burduna=bxn
Marwari\ (India)=rwr
Kushi=kuh
Tagish=tgx
Watut,\ South=mcy
Dghwede=dgh
Kuku-Muminh=xmh
Daho-Doo=das
Huave,\ San\ Dionisio\ Del\ Mar=hve
Dadibi=mps
Armenian\ Sign\ Language=aen
Rungus=drg
Keres,\ Western=kjq
Pech=pay
Mofu,\ North=mfk
Pawaia=pwa
Chinantec,\ Usila=cuc
Galindan=xgl
Quechua,\ Margos-Yarowilca-Lauricocha=qvm
Ukuriguma=ukg
Galoli=gal
Vaghua=tva
Namonuito=nmt
Kom\ (India)=kmm
Ngando\ (Democratic\ Republic\ of\ Congo)=nxd
Jur\ Modo=bex
Norman=nrm
Nyala,\ East=nle
Dendi\ (Central\ African\ Republic)=deq
Firan=fir
Sara=sre
Arabic,\ Ta'izzi-Adeni\ Spoken=acq
Manna-Dora=mju
Mixtec,\ Chayuco=mih
Tumleo=tmq
Colorado=cof
Ghulfan=ghl
Mirandese=mwl
Pijao=pij
Kabuverdianu=kea
Geman\ Deng=gen
Goundo=goy
Yemba=ybb
Emerillon=eme
Mongolian,\ Peripheral=mvf
Tereno=ter
Zinza=zin
Wardaman=wrr
Pear=pcb
Idun=ldb
Anyin\ Morofo=mtb
Yekora=ykr
Tarahumara,\ Lowland=tac
Ndamba=ndj
Lele\ (Papua\ New\ Guinea)=lle
Jordanian\ Sign\ Language=jos
Kao=kax
Sapo=krn
Yupik,\ Sirenik=ysr
Kam=kdx
Wichí\ Lhamtés\ Vejoz=wlv
Tonsea=txs
Yanesha'=ame
Leinong\ Naga=lzn
Albanian=sq
Catalonian\ Sign\ Language=csc
Menominee=mez
Tupí=tpw
Gelao=gio
Sausi=ssj
Sause=sao
English=en
Suruí\ Do\ Pará=mdz
Laha\ (Viet\ Nam)=lha
Mahou=mxx
Samba\ Leko=ndi
Wamin=wmi
Chinantec,\ Comaltepec=cco
Vaghri=vgr
Nindi=nxi
Tai\ Dam=blt
Areba=aea
Katu,\ Western=kuf
Wandarang=wnd
Onjob=onj
Banggarla=bjb
French\ Sign\ Language=fsl
Ngbaka=nga
Dogon,\ Kolum\ So=dkl
Allar=all
Ixil,\ San\ Juan\ Cotzal=ixl
Kgalagadi=xkv
Arakanese=mhv
Oromo,\ Eastern=hae
Zhang-Zhung=xzh
Sauri=srt
Zaza=zza
Cacua=cbv
Kayeli=kzl
Phola=ypg
Besisi=mhe
Yawiyo=ybx
Logorik=liu
Nyunga=nys
Isirawa=srl
Sami,\ Ume=sju
Mixtec,\ San\ Miguel\ El\ Grande=mig
Candoshi-Shapra=cbu
Kitja=gia
Tonga\ (Nyasa)=tog
Rongga=ror
Semelai=sza
Otomi,\ Querétaro=otq
Anserma=ans
Turi=trd
Sepa\ (Indonesia)=spb
Kalabari=ijn
Khandesi=khn
Hungarian=hu
Nimboran=nir
Venezuelan\ Sign\ Language=vsl
Labu=lbu
Dogon,\ Ana\ Tinga=dti
Barok=bjk
Lamja-Dengsa-Tola=ldh
Labo=mwi
Samo=smq
Barbacoas=bpb
Carapana=cbc
Kayah,\ Western=kyu
Mixtec,\ Yoloxochitl=xty
Zakhring=zkr
Djamindjung=djd
Luo\ (Kenya\ and\ Tanzania)=luo
Emok=emo
Laba=lau
Sama=smd
Trumaí=tpy
Nonuya=noj
Kepo'=kuk
Inuktitut=iu
Rennellese\ Sign\ Language=rsi
Guató=gta
Ninam=shb
Nogai=nog
Louisiana\ Creole\ French=lou
Meyah=mej
Korana=kqz
Tachoni=lts
Laal=gdm
Lenje=leh
Kawaiisu=xaw
Marriammu=xru
Mbowe=mxo
Wamey=cou
Subanen,\ Central=syb
Chinantec,\ Chiltepec=csa
Sala=shq
Gola=gol
Gitxsan=git
Holiya=hoy
Semnani=smy
Pashayi,\ Southeast=psi
Samosa=swm
Hurrian=xhu
Arabic,\ Saidi\ Spoken=aec
Chokwe=cjk
Seluwasan=sws
Aiome=aki
Nicaragua\ Creole\ English=bzk
Mbembe,\ Tigon=nza
Sake=sak
Isekiri=its
Kalou=ywa
Bomitaba=zmx
Nubian,\ Old=onw
Ikobi-Mena=meb
Idon=idc
Dogri\ (generic)=doi
Ainu\ (Japan)=ain
Mvanip=mcj
Nateni=ntm
Cakchiquel-Quiché\ Mixed\ Language=ckz
Tennet=tex
Mawayana=mzx
Oko-Juwoi=okj
Dobel=kvo
Muda=ymd
Walser=wae
Nasal=nsy
Umbu-Ungu=ubu
Australian\ Aborigines\ Sign\ Language=asw
Tzeltal,\ Bachajón=tzb
Yabarana=yar
Dela-Oenale=row
Koitabu=kqi
Gaikundi=gbf
Koraku=ksz
Greek,\ Ancient\ (to\ 1453)=grc
Bainouk-Samik=bcb
Bimin=bhl
Yaka\ (Democratic\ Republic\ of\ Congo)=yaf
Chatino,\ Zenzontepec=czn
Akhvakh=akv
Lengo=lgr
Wayanad\ Chetti=ctt
Settla=sta
Macuna=myy
Vamale=mkt
Tuvalu=tvl
Guianese\ Creole\ French=gcr
Tumak=tmc
Yi,\ Axi=yix
Senaya=syn
Belarusian\ (Belarus)=be
Garreh-Ajuran=ggh
Port\ Vato=ptv
Djinba=djb
Agarabi=agd
Sardinian,\ Sassarese=sdc
Tiang=tbj
Nahuatl,\ Santa\ María\ La\ Alta=nhz
Mubi=mub
Tumi=kku
Ngumbi=nui
Yi,\ Awu=yiu
Sahu=saj
Shekkacho=moy
Kwambi=kwm
Helambu\ Sherpa=scp
Ngumba=nmg
Saho=ssy
Bolango=bld
Malfaxal=mlx
Mbosi=mdw
Tulu=tcy
Qashqa'i=qxq
Chinali=cih
Kisankasa=kqh
Naga,\ Tutsa=tvt
Zapotec,\ Chichicapan=zpv
Wambule=wme
Kono\ (Sierra\ Leone)=kno
Wamas=wmc
Krisa=ksi
Karadjeri=gbd
Lokaa=yaz
Mon,\ Old=omx
Standard\ Estonian=ekk
Nkoya=nka
Sharanahua=mcd
Tula=tul
Sami,\ Akkala=sia
Kashubian=csb
Gogo=gog
Naga,\ Angami=njm
Norn=nrn
Nomatsiguenga=not
Zari=zaz
Päri=lkr
Basque=eu
Penrhyn=pnh
Lomavren=rmi
Tiale=mnl
Kendeje=klf
Lendu=led
Tuki=bag
Muria,\ Western=mut
Hwana=hwo
Nimadi=noe
Amerax=aex
Yangho=ynh
Aramaic,\ Samaritan=sam
Nomane=nof
Komba=kpf
Lardil=lbz
Skepi\ Creole\ Dutch=skw
Ndolo=ndl
Apinayé=apn
Ririo=rri
Grebo=grb
Vanuma=vau
Guragone=gge
Liberian\ English=lir
Manobo,\ Western\ Bukidnon=mbb
Woi=wbw
Gofa=gof
Mende\ (Sierra\ Leone)=men
Itneg,\ Binongan=itb
Wedau=wed
Ayta,\ Mag-Indi=blx
Kitan=zkt
Kung-Ekoka=knw
Tindi=tin
Maithili=mai
Terebu=trb
Yahang=rhp
Luyana=lyn
Mixtec,\ Silacayoapan=mks
Zeeuws=zea
Chalikha=tgf
Nepal\ Bhasa=new
Futuna-Aniwa=fut
Saep=spd
Mahei=mja
Kapori=khp
Umbuygamu=umg
Saek=skb
Niuafo'ou=num
Philippine\ Sign\ Language=psp
Lenca=len
Omejes=ome
English\ (Singapore)=en
Arabic\ (Sudan)=ar
Madngele=zml
Aiku=mzf
Hukumina=huw
Shughni=sgh
Tuwuli=bov
Gyele=gyi
Karen,\ Bwe=bwe
Potawatomi=pot
Danau=dnu
Macedonian\ (Macedonia)=mk
Saterfriesisch=stq
Korafe=kpr
Magahat=mtw
Atsugewi=atw
Noon=snf
Ngindo=nnq
Kriol=rop
Zapotec,\ Elotepec=zte
Nicobarese,\ Southern=nik
Hidatsa=hid
Nchumbulu=nlu
Diuwe=diy
Bina\ (Papua\ New\ Guinea)=bmn
Serawai=srj
Taikat=aos
Shabak=sdb
Kaki\ Ae=tbd
Wayuu=guc
Bambalang=bmo
Yandruwandha=ynd
Haroi=hro
Kayan=pdu
Salampasu=slx
Maiani=tnh
Janji=jni
Amarakaeri=amr
Matumbi=mgw
Efutop=ofu
Hitu=htu
Trimuris=tip
Mofu-Gudur=mif
Benggoi=bgy
Canichana=caz
Warembori=wsa
Pankhu=pkh
Chilcotin=clc
Sabu=hvn
Mixtec,\ Ocotepec=mie
Gobu=gox
Nomu=noh
Gbii=ggb
Numana-Nunku-Gbantu-Numbu=nbr
Bardi=bcj
Kompane=kvp
Gungu=rub
Kayan,\ Rejang=ree
Dugun=ndu
Nungali=nug
Guajá=gvj
Jarnango=jay
Paekche=pkc
Akkadian=akk
Gamo-Ningi=bte
Saba=saa
Wadjigu=wdu
Yerong=yrn
Sialum=slw
Palaung,\ Shwe=pll
Loma\ (Liberia)=lom
Malagasy=mg
Tambas=tdk
Avau=avb
Tzutujil,\ Eastern=tzj
Lobu,\ Lanas=ruu
Mabaan=mfz
Saam=raq
Amanab=amn
Kurama=krh
Yakamul=ykm
Kukatja=kux
tlhIngan-Hol=tlh
Naga,\ Northern\ Rengma=nnl
Ganglau=ggl
Bakairí=bkq
Mbole=mdq
Turkish=tr
Tjurruru=tju
Ndogo=ndz
Shawnee=sjw
Rer\ Bare=rer
Pémono=pev
Tomedes=toe
Imeraguen=ime
Tawoyan=twy
Umbindhamu=umd
Ukrainian\ Sign\ Language=ukl
Southern\ Bontok=obk
Pileni=piv
Ukaan=kcf
Atayal=tay
Ede\ Nago,\ Kura=nqk
Yucatec\ Maya\ Sign\ Language=msd
Paranawát=paf
Urali=url
Watut,\ North=una
Kayan,\ Mendalam=xkd
Cuvok=cuv
Mboko=mdu
Gbe,\ Defi=gbh
Mamboru=mvd
Embu=ebu
Kurti=ktm
Manggarai=mqy
Gbe,\ Ayizo=ayb
Jewish\ Palestinian\ Aramaic=jpa
Maindo=cwb
Yupik,\ Naukan=ynk
Tübatulabal=tub
Wichí\ Lhamtés\ Güisnay=mzh
Khlor=llo
Baras=brs
Wogamusin=wog
Nawaru=nwr
Mam,\ Central=mvc
Yauma=yax
Selee=snw
Barai=bbb
Longuda=lnu
Boano\ (Sulawesi)=bzl
Wushi=bse
Lembata,\ South=lmf
Eman=emn
Quinqui=quq
Gundi=gdi
Gobasi=goi
Paliyan=pcf
Peere=pfe
Nyangatom=nnj
Emae=mmw
Matepi=mqe
Sherpa=xsr
Busami=bsm
Komi-Zyrian=kpv
Yupik,\ Pacific\ Gulf=ems
Spanish\ (Puerto\ Rico)=es
Sori-Harengan=sbh
Yaleba=ylb
Sateré-Mawé=mav
Shanenawa=swo
Sicel=scx
Ambakich=aew
Ngalkbun=ngk
Eruwa=erh
Abaza=abq
Wanukaka=wnk
Kharia=khr
Jadgali=jdg
Lewotobi=lwt
Plains\ Indian\ Sign\ Language=psd
Dibole=bvx
Chinese\ (Singapore)=zh
Kalao=kly
Faita=faj
Koshin=kid
Kalam=kmh
Myene=mye
Estonian\ (Estonia)=et
Xavánte=xav
Ngambay=sba
Toaripi=tqo
Dení=dny
Momare=msz
Tharu,\ Chitwania=the
Murrinh-Patha=mwf
Cao\ Miao=cov
Kota\ Marudu\ Talantang=grm
Ndobo=ndw
Makayam=aup
Romanian,\ Istro=ruo
Kunjen=kjn
Rawat=jnl
Rawas=rws
Weh=weh
Koli,\ Parkari=kvx
Tsakwambo=kvz
Cakchiquel,\ Santa\ María\ De\ Jesús=cki
Arikem=ait
Katu,\ Eastern=ktv
Mazatec,\ San\ Jerónimo\ Tecóatl=maa
Manipuri,\ Old=omp
Nimoa=nmw
Jinyu\ Chinese=cjy
Vaagri\ Booli=vaa
Kalinga,\ Southern=ksc
Tinputz=tpz
French\ (Canada)=fr
Yangman=jng
Buksa=tkb
Kuanhua=xnh
Malay,\ Makassar=mfp
Munji=mnj
Marenje=vmr
Rahambuu=raz
Ndombe=ndq
Bagheli=bfy
Otoro=otr
Jju=kaj
Krui=krq
Cabécar=cjp
Ulumanda'=ulm
Hmong\ Njua=hnj
Malagasy,\ Sakalava=skg
Pontic=pnt
Pubian=pun
Gadsup=gaj
Koyaga=kga
Munit=mtc
Amuzgo\ (San\ Pedro\ Amuzgos)=azg
Naga,\ Chothe=nct
Chamacoco=ceg
Quechua,\ Northern\ Conchucos\ Ancash=qxn
Ramopa=kjx
Karakhanid=xqa
Auye=auu
Hinduri=hii
Pashayi,\ Southwest=psh
Tepecano=tep
Arabic,\ Judeo-Tripolitanian=yud
Samoan=sm
Lamenu=lmu
Pumi,\ Northern=pmi
Narom=nrm
Barbareño=boi
Krenak=kqq
Miwok,\ Bay=mkq
Chichewa=ny
Bina\ (Nigeria)=byj
Horned\ Miao=hrm
Chinantec,\ Tlacoatzintepec=ctl
Akrukay=afi
Eloyi=afo
Ojibwa,\ Severn=ojs
Maninkakan,\ Western=mlq
Arabic,\ Judeo-Iraqi=yhd
Atsam=cch
Saxon,\ Old=osx
Montagnais=moe
Guatemalan\ Sign\ Language=gsm
Lushai=lus
Palawano,\ Southwest=plv
Yagnobi=yai
Haeke=aek
Bhele=bhy
Wik-Me'anha=wih
Kayupulau=kzu
Yevanic=yej
Mazahua,\ Michoacán=mmc
Bati\ (Indonesia)=bvt
Panim=pnr
Gaelic,\ Hiberno-Scottish=ghc
Toku-No-Shima=tkn
War=aml
Deno=dbb
Hamtai=hmt
Butmas-Tur=bnr
Wan=wan
Puerto\ Rican\ Sign\ Language=psl
Arabic\ (Judeo-Yemeni)=jye
Auwe=smf
Santa\ Cruz=stc
Ma'ya=slz
Komodo=kvh
Wab=wab
Biyom=bpm
Coyaima=coy
Quichua,\ Northern\ Pastaza=qvz
Mixtec,\ Chazumba=xtb
Tai\ Pao=tpo
Mator=mtm
Amblong=alm
Bakumpai=bkr
Pokomam,\ Eastern=poa
Aurá=aux
Bilur=bxf
Northern\ Zhuang=ccx
Ghayavi=bmk
Dutch=nl
Dedua=ded
Silesian=szl
Dema=dmx
Guambiano=gum
Bilua=blb
Thao=ssf
Biangai=big
Delo=ntr
Thai=th
Askopan=eiv
Borna=bxx
Kombio=xbi
Hungarian,\ Old=ohu
Kaibobo=kzb
Ofayé=opy
Jacalteco,\ Western=jai
Mangarayi=mpc
Lumbee=lmz
Banda\ (Indonesia)=bnd
Persian\ Sign\ Language=psc
Digaro-Mishmi=mhu
Tanjijili=uji
Chehalis,\ Lower=cea
Ese\ Ejja=ese
Gugubera=kkp
Phu\ Thai=pht
Kru'ng\ 2=krr
Mono\ (Democratic\ Republic\ of\ Congo)=mnh
Spanish\ (Bolivia)=es
Hawai'i\ Creole\ English=hwc
Paama=pma
Jeh=jeh
Quechua=qu
Guruntum-Mbaaru=grd
Hattic=xht
Kuria=kuj
Dogon,\ Jamsay=djm
Setswana=tn
Queyu=qvy
Tepehua,\ Tlachichilco=tpt
Munda=unx
Totonac,\ Coyutla=toc
Kolom=klm
Perai=wet
Tadyawan=tdy
Gazi=gzi
Kalanga=kck
Hindko,\ Northern=hno
Alangan=alj
Yali,\ Pass\ Valley=yac
Dongo=doo
Sãotomense=cri
Vincentian\ Creole\ English=svc
Kaningra=knr
Zapotec,\ Loxicha=ztp
Mlahsö=lhs
Sentinel=std
Amikoana=akn
Gabutamon=gav
Shubi=suj
Moklen=mkm
Wali\ (Sudan)=wll
Maiwa\ (Papua\ New\ Guinea)=mti
Canela=ram
Grangali=nli
Pingelapese=pif
Gayo=gay
Marti\ Ke=zmg
Pagibete=pae
Narim=loh
Sirionó=srq
Serbian\ (Bosnia\ and\ Herzegovina)=sr
Mpoto=mpa
Bekati'=bei
Paulohi=plh
Kakwa=keo
Shuar=jiv
Japanese\ (Japan,JP)=ja
Min\ Dong=cdo
Tofanma=tlg
Sindarin=sjn
Mazatec,\ Ixcatlán=mzi
Pande=bkj
Balanta-Ganja=bjt
Shoshoni=shh
Nyigina=nyh
Columbia-Wenatchi=col
Kete=kcv
Bekwarra=bkv
Agta,\ Dupaninan=duo
Muria,\ Eastern=emu
Gbayi=gyg
Twana=twa
Dehu=dhv
Bernde=bdo
Bandjalang=bdy
Nupbikha=npb
Iguta=nar
Aralle-Tabulahan=atq
Bainouk-Gunyuño=bab
Kinyarwanda=rw
Bozaba=bzo
Langobardic=lng
Caramanta=crf
Bwamu,\ Láá\ Láá=bwj
Fijian=fj
Kaingáng,\ São\ Paulo=zkp
Phangduwali=phw
Parthian=xpr
Gumuz=guk
Layakha=lya
Ningye=nns
Kuthant=xut
Dondo=dok
Hiligaynon=hil
Mussau-Emira=emi
Taabwa=tap
Kare\ (Central\ African\ Republic)=kbn
Hmong,\ Western\ Mashan=hmw
Jad=jda
Sierra\ Negra\ Nahuatl=nsu
Muria,\ Far\ Western=fmu
Shanga=sho
Raetic=xrr
Lower\ Burdekin=xbb
Higaonon=mba
Gata'=gaq
Ngizim=ngi
Mengisa=mct
Walio=wla
Kera=ker
Arabela=arl
Tai\ Hang\ Tong=thc
Tucano=tuo
Ukwuani-Aboh-Ndoni=ukw
Timne=tem
Muji\ Yi=ymj
Nuni,\ Southern=nnw
Romkun=rmk
Foia\ Foia=ffi
Wolof,\ Gambian=wof
Huave,\ Santa\ María\ Del\ Mar=hvv
Lithuanian=lt
Nobiin=fia
Finnish=fi
Toala'=tlz
Punan\ Bah-Biau=pna
Owenia=wsr
Dyaabugay=dyy
Minaveha=mvn
Soqotri=sqt
Koro\ (Papua\ New\ Guinea)=kxr
Swiss-French\ Sign\ Language=ssr
Spanish,\ Old=osp
Yawuru=ywr
Traveller\ Norwegian=rmg
Tarok=yer
Fembe=agl
Bolondo=bzm
Tacanec=mtz
Yamdena=jmd
Cuba\ Sign\ Language=csf
Chemakum=xch
Popoluca,\ Oluta=plo
Krio=kri
Khinalugh=kjj
Elseng=mrf
Arapesh,\ Bumbita=aon
Putoh=put
Krim=krm
Meadow\ Mari=mhr
Remun=lkj
Cornish,\ Middle=cnx
Mixtec,\ Sindihui=xts
Lacandon=lac
Chilisso=clh
Bogaya=boq
Cao\ Lan=mlc
Kayan,\ Kayan\ River=xkn
Parauk=prk
Fordata=frd
Horpa=ero
Ecuadorian\ Sign\ Language=ecs
Limassa=bme
Siona=snn
Nahuatl,\ Eastern\ Huasteca=nhe
Kombai=tyn
Nalögo=nlz
Dhaiso=dhs
Dezfuli=def
Badui=bac
Carian=xcr
Naga,\ Inpui=nkf
Tonga\ (Thailand)=tnz
Turkish,\ Old=otk
Riantana=ran
Horom=hoe
Kodeoha=vko
Borei=gai
Hmong\ Shua=hmz
Bacama=bcy
Urningangg=urc
Kpelle,\ Guinea=gkp
Ubir=ubr
Yendang=yen
Garo=grt
Malua\ Bay=mll
Arandai=jbj
So'a=ssq
Lemio=lei
Cuiba=cui
Ignaciano=ign
Kanowit=kxn
Moi\ (Congo)=mow
Yaweyuha=yby
Viti=vit
Maranunggu=zmr
Romani,\ Carpathian=rmc
Limousin=lms
Kunduvadi=wku
Mouk-Aria=mwh
Mbalanhu=lnb
Chiangmai\ Sign\ Language=csd
Narau=nxu
Paraujano=pbg
Gbari=gby
Sundanese=su
Zyphe=zyp
Matipuhy=mzo
Bhilali=bhi
Narak=nac
Kelo=xel
Selkup=sel
Gallegan=gl
Luguru=ruf
Pokomam,\ Central=poc
Nyoro=nyo
Mekeo=mek
Medebur=mjm
Bilin=byn
Inuktitut\ (Eastern\ Canadian)=ike
Laven=lbo
Nyore=nyd
Masela,\ Central=mxz
Kharia\ Thar=ksy
Zapotec,\ San\ Juan\ Guelavía=zab
Ngarla=nlr
Karanga=kth
Iyo=nca
Abaga=abg
Abai\ Sungai=abf
Gbagyi=gbr
Arabic\ (Morocco)=ar
I-Wak=iwk
Marovo=mvo
Changriwa=cga
Wadjiginy=wdj
Tzutujil,\ Western=tzt
Huilliche=huh
One,\ Northern=onr
Arguni=agf
Mongolian=mn
Waropen=wrp
Achinese=ace
Bukat=bvk
Rudbari=rdb
Ahom=aho
Lavukaleve=lvk
Rempi=rmp
Defaka=afn
Sauria\ Paharia=mjt
Phala=ypa
Ama\ (Sudan)=nyi
Matal=mfh
Bengkulu=bke
Amele=aey
Negerhollands=dcr
Cinta\ Larga=cin
Aariya=aay
Ojibwa,\ Eastern=ojg
Laopang=lbg
Mpongmpong=mgg
Chickasaw=cic
Kesawai=xes
Ebrié=ebr
Wotapuri-Katarqalai=wsv
Walak=wlw
Fuliiru=flr
Hadza=hts
Nayi=noz
Nahuatl,\ Guerrero=ngu
Hõne=juh
Gane=gzn
Phake=phk
Tujia,\ Southern=tjs
Gurdjar=gdj
Bariji=bjc
Ngungwel=ngz
Gana=gnq
Seraiki=skr
Elip=ekm
Kein=bmh
Koli,\ Wadiyara=kxp
Sunam=ssk
Gbanu=gbv
Phoenician=phn
Ngurimi=ngq
Apache\ (Western)=apw
Kanyok=kny
Lingua\ Franca\ Nova=lfn
Sami,\ Ter=sjt
Gamo=gmv
Abadi=kbt
Warkay-Bipim=bgv
Mvuba=mxh
Uruguayan\ Sign\ Language=ugy
Sos\ Kundi=sdk
Tagabawa=bgs
Naxi=nbf
Breton,\ Old=obt
Kehu=khh
Mexican\ Sign\ Language=mfs
Ndasa=nda
Western\ Neo-Aramaic=amw
Jurúna=jur
Akpes=ibe
Chuj\ (San\ Sebastián\ Coatán)=cac
Chopi=cce
Yankunytjatjara=kdd
Kisar=kje
Quechua,\ Santa\ Ana\ de\ Tusi\ Pasco=qxt
Nyong=muo
Eyak=eya
Finnish\ (Finland)=fi
Jerung=jee
Arrernte,\ Eastern=aer
Ainbai=aic
Agta,\ Mt.\ Iriga=agz
Yoidik=ydk
Nyindu=nyg
Morerebi=xmo
Dambi=dac
Olekha=ole
Norra=nrr
Zo'é=pto
Kalamsé=knz
Subanon,\ Kolibugan=skn
Hupa=hup
Mixtec,\ Northern\ Tlaxiaco=xtn
Mongolian,\ Halh=khk
Budong-Budong=bdx
Niuatoputapu=nkp
Tulishi=tey
Sorsogon,\ Waray=srv
Bantawa=bap
Bezhta=kap
Jamaican\ Country\ Sign\ Language=jcs
Ito=itw
Pidgin,\ Timor=tvy
Ndendeule=dne
Damal=uhn
English\ (Australia)=en
Ngwaba=ngw
Japrería=jru
Maninkakan,\ Eastern=emk
Choni=cda
u=ngh
Taromi,\ Upper=tov
Chong=cog
Sikule=skh
Nyole=nuj
Nepalese\ Sign\ Language=nsp
Lakota=lkt
Jhankot\ Sign\ Language=jhs
Yang\ Zhuang=zyg
Timbe=tim
Kalkutungu=ktg
Vili=vif
Ija-Zuba=vki
Koenoem=kcs
Tharu,\ Dangaura=thl
Gorontalo=gor
Zapotec,\ Tlacolulita=zpk
Kanuri,\ Bilma=bms
Yámana=yag
Maltese\ (Malta)=mt
Gongduk=goe
Wayampi=oym
Hung=hnu
Waigali=wbk
Tatana=txx
Manombai=woo
Pancana=pnp
Marghi\ South=mfm
Nahuatl,\ Central\ Puebla=ncx
Mbato=gwa
U=uuu
Pomo,\ Southern=peq
Nahuatl,\ Tlamacazapa=nuz
Mbati=mdn
Rangpuri=rkt
Gail=gic
N=ngh
Bilba=bpz
Kpelle,\ Liberia=xpe
Hmong,\ Western\ Xiangxi=mmr
E=eee
Mor\ (Mor\ Islands)=mhz
Ma'di=mhi
Zarma=dje
Lomaiviti=lmv
Malagasy,\ Masikoro=msh
Jurchen=juc
\==huc
Araona=aro
Legenyem=lcc
Arabic,\ Sudanese\ Creole=pga
ǂKx’auǁ’ein=aue
Gnau=gnu
Suabo=szp
Ulithian=uli
Tigrinya=ti
Pashto=ps
Bukitan=bkn
Finallig=bkb
Nukna=klt
Huli=hui
Yagua=yad
Tolowa=tol
Banda,\ West\ Central=bbp
Chambeali=cdh
Yeyi=yey
Gagu=ggu
Jacalteco,\ Eastern=jac
Bunu,\ Bu-Nao=bwx
Kachin=kac
Anyin=any
Omati=mgx
Hula=hul
Naro=nhr
Plautdietsch=pdt
Ningil=niz
Boro=bwo
Quechan=yum
Shakara=nfk
Mohegan-Pequot=xpq
Pamosu=hih
Nara=nrb
Dogon,\ Toro\ So=dts
Bora=boa
Remo=rem
Kravet=krv
