#lng2name_FR
#Tue Apr 10 01:09:46 CEST 2012
zyphe=zyp
langue\ des\ signes\ finnoise=fse
bobo\ madaré\ (du\ Sud)=bwq
catawba=chc
limbou=lif
baraï=bbb
bini=bin
malgache\ (betsimisaraka\ du\ Sud)=bjq
arabe\ (lybien)=ayl
vaï=vai
picard=pcd
kaingáng=kgp
judéo-arabe=jrb
avestique=ae
tuvalu=tvl
hupa=hup
coréen=ko
bamoun=bax
dogrib=dgr
indéterminée=und
naï=bio
anglais\ (Singapour)=en
zapotèque\ (Santo-Domingo\ Albarradas)=zas
sindhî=sd
tagalog=tl
indonésien\ (Indonésie)=in
norvégien=no
danois=da
assiniboine=asb
tokharien\ B=txb
tokharien\ A=xto
estrémadure=ext
eyak=eya
serbe\ (Serbie\ et\ Monténégro)=sr
coquille=coq
rromani\ {sic}=rom
maldivien=dv
zoque\ (Tabasco)=zoq
dakota=dak
tigrigna=ti
lacandon=lac
letton\ (Lettonie)=lv
portugais\ (Brésil)=pt
arabe\ (Hijazi)=acw
yapois=yap
italien\ (Suisse)=it
tabassaran=tab
javanais=jv
zapotèque\ (ozolotépèque)=zao
yiddish=yi
serbe\ (Bosnie-Herzégovine)=sr
finnois\ (Kven)=fkv
islandais\ (Islande)=is
haoussa=ha
carrier=crx
bedja=bej
nahali=nlx
chamorro=ch
aïnou\ (Japon)=ain
nauruan=na
espagnol=es
coréen\ (Corée\ du\ Sud)=ko
tsakhour=tkr
arabe\ (Qatar)=ar
hruso=hru
irlandais\ ancien=sga
papago=ood
Maranao=mrw
zapotèque\ (Xadani)=zax
anglais=en
arabe\ (Libye)=ar
grebo=grb
venda=ve
filipino=fil
arabe\ (Maroc)=ar
atikamekw=atj
zoque\ (Chimalapa)=zoh
tuxináwa=tux
muskogee=mus
zapotèque\ (San-Baltazar\ Loxicha)=zpx
flamand=vls
espagnol\ (République\ Dominicaine)=es
arabe\ (Hadrami)=ayh
turc=tr
bati\ (Indonésie)=bvt
quechua\ panao=qxh
bijorî=bix
gun=guw
ukrainien\ (Ukraine)=uk
badeshî=bdz
norvégien\ (Norvège)=no
Karone\ (langue)=krx
hounzib=huz
nzema=nzi
tanana=taa
wanukaka=wnk
macédonien=mk
étrusque=ett
kurde=ku
karakalpak=kaa
samo=smq
tchamalal=cji
rundi=rn
hébreu=iw
ojibwa=oj
phénicien=phn
pendjabi=pa
créole\ du\ Cap-Vert=kea
asturien=ast
tupi=tpw
anglais\ (Australie)=en
sarde=sc
pawnee=paw
altaïque\ (du\ Nord)=aqn
Manipourî\ de\ Bishnupriya=bpy
portugais\ (Portugal)=pt
hongrois\ (Hongrie)=hu
éwondo=ewo
malais\ (Malaisie)=ms
aragonais=an
créole\ anglais\ Fernando\ Po=fpe
ouïgour=ug
émilien=eml
tsonga=ts
bissaya\ (de\ Brunéi)=bsb
nyoro=nyo
dargwa=dar
nganassan=nio
piémontais=pms
espagnol\ (El\ Salvador)=es
espagnol\ (Nicaragua)=es
apache\ (Jicarilla)=apj
Mancagne\ (langue)=knf
wolaitta=wal
rifain=rif
Koriak=kpy
cao\ miao=cov
singhalais=si
quapaw=qua
jarawa\ (Inde)=anq
néo-araméen\ de\ Bohtan=bhn
cree=cr
grec\ (Grèce)=el
caddo=cad
syriaque=syr
rwanda=rw
Kerek=krk
gagaouze=gag
kiribati=gil
mbangwé=zmn
serbe\ (Monténégro)=sr
seneca=see
bichlamar=bi
arabe\ (Baharna)=abv
croate=hr
bhojpurî=bho
zapotèque\ (Chichicapan)=zpv
taiap=gpn
lithuanien\ (Lithuanie)=lt
kawi=kaw
t'en=tct
angami\ naga=njm
esclave\ (athapascan)=den
manipuri=mni
espagnol\ (Uruguay)=es
béli\ (Papouasie-Nouvelle-Guinée)=bey
kanouri=kr
swahili=sw
oneida=one
ido=io
sandawe=sad
allemand=de
arabe\ (parlé\ du\ Golfe)=afb
français\ (Suisse)=fr
bada\ (Indonésie)=bhz
turc\ ottoman=ota
tiv=tiv
apache\ (Kiowa)=apk
langue\ des\ signes\ québecoise=fcs
malais\ (Berau)=bve
arabe\ (Najdi)=ars
hittite=hit
jargon\ chinook=chn
bulgare=bg
allemand\ (Suisse)=de
français\ (France)=fr
créole\ français\ de\ Sainte-Lucie=acf
méroïtique=xmr
zenaga=zen
chitimacha=ctm
allemand\ (Allemagne)=de
quechua\ huaylla=qvw
créole\ néerlandais\ de\ Berbice=brc
zapotèque\ (Tabaa)=zat
judéo-espagnol=lad
laal=gdm
finnois\ tornedalien=fit
frison\ (occidental)=fy
suédois\ (Suède)=sv
albanais\ (Arvanitika)=aat
zapotèque\ (mixtépèque)=zpm
néo-araméen\ juif\ barzani=bjf
slavon\ d'église\ vieux=cu
comanche=com
banda\ (Indonésie)=bnd
arménien\ (moyen)=axm
ancien\ français=fro
yi\ de\ Sichuan=ii
anglais\ (Afrique\ du\ Sud)=en
albanais\ (Albanie)=sq
lolo=llb
zapotèque\ (El\ Alto)=zpp
dzongkha=dz
langue\ des\ signe\ balinaise=bqy
(aucun)=zxx
wiraféd=wir
zéeuws=zea
yao=yao
kabyle=kab
gond=gon
nadruvien=ndf
sotho\ du\ Nord=nso
mbo\ (République\ démocratique\ du\ Congo)=zmw
norvégien\ bokmål=nb
arabe\ (Arabie\ Saoudite)=ar
zapotèque\ (Mitla)=zaw
selkoup=sel
néerlandais\ (Pays-Bas)=nl
austral=aut
baka\ (Cameroun)=bkc
hongrois=hu
zapotèque\ (Lachiguiri)=zpa
espagnol\ (Honduras)=es
chinois=zh
birifor\ (du\ Sud)=biv
volapük=vo
zapotèque\ (Yautépèque)=zpb
ndonga=ng
tetum=tet
allemand\ pennsylvanien=pdc
thaï\ (Thaïlande,TH)=th
irlandais\ moyen=mga
frioulan=fur
tahitien=ty
newari=new
vieux\ perse\ (ca.\ 600–400\ av.\ J.-C.)=peo
tchèque=cs
onondaga=ono
herero=hz
latin=la
wallon=wa
luba-katanga=lu
zapotèque\ (Rincon)=zar
allemand\ (Luxembourg)=de
malayalam=ml
zhuang=za
danois\ (Danemark)=da
dogri\ (générique)=doi
ou(s)zbek=uz
langue\ des\ signes\ arménienne=aen
bas-sorabe=dsb
moyen\ haut\ allemand=gmh
vénète=vec
ourdou=ur
ladin=lld
tatar\ de\ Crimé=crh
zapotèque\ (Guévéa\ de\ Humboldt)=zpg
tatar=tt
fidjien=fj
karène\ (Pa’o)=blk
créole\ guadeloupéen=gcf
galicien=gl
chleuh=shi
cebuano=ceb
créole\ anglais\ d’Antigua-et-Barbuda=aig
angkola\ batak=akb
créole\ surinamien=srn
bissaya\ (de\ Sabah)=bsy
zapotèque\ (Yareni)=zae
xipináwa=xip
tongan\ (Îles\ Tonga)=to
gujarâtî=gu
zapotèque\ (San-Juan\ Guelavia)=zab
adyghé=ady
arawak=arw
quechua\ chachapoyas=quk
espagnol\ (Mexique)=es
cornique=kw
rapanui=rap
tuamotuan=pmt
langue\ des\ signes\ zambienne=zsl
arabe\ (chypriote)=acy
chuuk=chk
pochuri\ naga=npo
malgache\ (de\ Bara)=bhr
zapotèque\ (San-Pedro\ Quiatoni)=zpf
pima=pia
basque=eu
huilliche=huh
arabe\ (lévantin\ du\ Nord)=apc
grec\ (moderne)=el
zapotèque\ (Miahuatlan)=zam
tutelo=tta
harari=har
ganda=lg
tokelau(an)=tkl
sami\ d'Inari=smn
bodo\ (Inde)=brx
arabe\ (Soudan)=ar
kashmiri=ks
zapotèque\ (Texmélucan)=zpz
ute=ute
tat=ttt
moksa=mdf
chinois\ (Hong-Kong)=zh
zapotèque\ (Tilquiapan)=zts
hidatsa=hid
espagnol\ (Colombie)=es
chipewyan=chp
tchouvache=cv
massaï=mas
slovaque\ (Slovaquie)=sk
tchèque\ (République\ Tchèque)=cs
pali=pi
aymara=ay
guèze=gez
breton=br
japonais\ (Japon)=ja
lao=lo
aceh=ace
quechua=qu
lak=lbe
bouriate=bua
pied-noir\ (siksika)=bla
zapotèque\ (mixtépèque\ d’Assuncion)=zoo
dalmate=dlm
chilcotin=clc
cheyenne=chy
bavarois=bar
kurukh=kru
zapotèque\ (Choapan)=zpc
santal=sat
langue\ des\ signes\ américaine=ase
nias=nia
apache\ (Lipan)=apl
wolof=wo
zapotèque\ (Sierra\ de\ Juarez)=zaa
espagnol\ (Guatemala)=es
ofo=ofo
futuna\ (oriental)=fud
tamacheq=tmh
quechua\ jauja=qxw
baï\ (du\ Sud)=bfs
finnois=fi
tereno=ter
corse=co
zoque\ (Francisco\ Leon)=zos
créole\ hawaiien=hwc
zapotèque\ (Quiavicuzas)=zpj
lushai=lus
kannada=kn
tok\ pisin=tpi
fang=fan
azéri\ (du\ Sud)=azb
sogdien=sog
malais=ms
luxembourgeois=lb
lithuanien=lt
karatchaï\ balkar=krc
langue\ des\ signes\ argentine=aed
oudi=udi
sami\ skolt=sms
nyanja=ny
frison\ septentrional=frr
souabe=swg
adangme=ada
khvarchi=khv
khotanais=kho
nukuini=nuc
biélorusse=be
gen=gej
inuktitut=iu
quechua\ huaylas=qwh
italien\ (Italie)=it
laz(e)=lzz
jacalteco=jac
chinois\ (Chine)=zh
makassar=mak
kpellé=kpe
zapotèque\ (Ayoquesco)=zaf
espagnol\ (Argentine)=es
maithili=mai
rhuthène=rue
ossète=os
sérère=srr
naskapi=nsk
arabe\ (Bédawi\ égyptien\ oriental)=avl
ilocano=ilo
arabe\ (Koweit)=ar
français=fr
navaho=nv
hindi=hi
galla=om
saponi=spi
stoney=sto
akan=ak
mégléno-roumain=ruq
hakka=hak
français\ (Belgique)=fr
aléoute=ale
kamba=kam
arabe=ar
zapotèque\ (Lachixio)=zpl
anglais\ (Etats-Unis)=en
cupeno=cup
zarphatique=zrp
bumthang=kjz
dong=doh
gaélique\ écossais=gd
espagnol\ (Panama)=es
zapotèque\ (San-Vicente\ Coatlan)=zpt
zapotèque\ (Santa-Maria\ Quiégolani)=zpi
kuanyama=kj
luiseno=lui
kabardien=kbd
mari=chm
arabe\ (Algérie)=ar
sulung=suv
cambrien=xcb
espagnol\ (Equateur)=es
créole\ haïtien=ht
magahi=mag
badui=bac
letton=lv
somali=so
lakkia=lbc
chinois\ (Taiwan)=zh
swati=ss
tunica=tun
hiligaynon=hil
balotchî\ (occidental)=bgn
turkmène=tk
chippewa=ciw
poyanáwa=pyn
istrio-roumain=ruo
tangkhul\ naga=nmf
ladakhi=lbj
kazakh=kk
abaza=abq
albanais\ (Tosk)=als
bengali=bn
élamite=elx
sanskrit=sa
langue\ des\ signes\ autrichienne=asq
nogaï=nog
zapotèque\ (Santa-Inès\ Yatzéchi)=zpn
baloï=biz
wichita=wic
oroko=bdu
chan=shn
araméen\ samaritain=sam
géorgien=ka
gallois=cy
créole\ réunionnais=rcf
kiowa=kio
karène\ (Bwé)=bwe
laurentiennes=lre
bali\ (nigérian)=bcn
sicilien=scn
birman=my
anglais\ moyen=enm
iakoute=sah
zapotèque\ (Cajonos)=zad
sherpa=xsr
bas\ allemand=nds
pontique=pnt
khmer=km
cachoube=csb
minangkabau=min
bilen=byn
chaoui=shy
hadza=hts
kachin=kac
espagnol\ (Chili)=es
vepse=vep
ligure=lij
araucan=arn
arabe\ (standard)=arb
anglo-saxon=ang
keriu=kri
kafa=kbr
zapotèque\ (Zaachila)=ztx
svan(e)=sva
pahlavi=pal
portugais=pt
shiluk=shk
estonien\ (Estonie)=et
rama=rma
arabe\ (Bahreïn)=ar
bouriate\ (Chine)=bxu
manx=gv
soninké=snk
albanais\ (Gheg)=aln
tibétain=bo
touva=tyv
serbe=sr
arabe\ (mésopotamien)=acm
turc\ (Turquie)=tr
moyen\ français=frm
gorontalo=gor
arabe\ (parlé\ de\ Ta’izzi-Adeni)=acq
rarotonga=rar
japonais=ja
persan=fa
vieux\ haut\ allemand=goh
swi=swi
néerlandais\ (Belgique)=nl
baï=bdj
zapotèque=zap
turkana=tuv
avar=av
langue\ des\ signes\ de\ Ban\ Khor=bfk
afrikaans=af
éblaïte=xeb
quechua\ huallaga=qub
kara\ (Corée)=zra
malais\ (bacanais)=btj
zapotèque\ (Ocotlan)=zac
bagvalal=kva
sasak=sas
espagnol\ (Espagne)=es
malécite=pqm
zeme\ naga=nzm
bouriate\ (Russie)=bxr
afar=aa
saramaccan=srm
sango=sg
boko\ (République\ démocratique\ du\ Congo)=bkp
(multiple)=mul
espéranto=eo
albanais=sq
bezhta=kap
karata=kpt
grec\ (Chypre)=el
tuscarora=tus
boudoukh=bdk
maori=mi
nottoway=ntw
turc\ gagaouze\ des\ Balkans=bgx
bodo\ (centrafricain)=boy
arabe\ (Irak)=ar
suédois=sv
quechua\ chiquian=qxa
woccon=xwc
hani=hni
arabe\ (Sahara\ algérien)=aao
klingon=tlh
nyamwezi=nym
Kölsch=ksh
maltais\ (Malte)=mt
éwé=ee
ulithian=uli
arabe\ (ouzbek)=auz
bachkir=ba
acoli=ach
baï\ (du\ Nord)=bfc
bemba=bem
islandais=is
micmac=mic
groenlandais=kl
britonnique=bzt
zapotèque\ (Téjalapan)=ztt
zay=zwa
arabe\ (égyptien)=arz
judéo-persan=jpr
zapotèque\ (Zaniza)=zpw
oudmourte=udm
tamoul=ta
biélorusse\ (Biélo-Russie)=be
zapotèque\ (Coatecas\ Altas)=zca
langue\ des\ signes\ bulgare=bqn
espagnol\ (Paraguay)=es
waray=war
ombrien=xum
chamicura=ccc
jinghpo=sgp
moré=mos
bô\ (Papouasie-Nouvelle-Guinée)=bpw
japonais\ (Japon,JP)=ja
vietnamien\ (Vietnam)=vi
tonga\ (Nyasa)=tog
Baoulé=bci
allemand\ (Autriche)=de
langue\ des\ signes\ de\ Bamako=bog
aïnou\ (Chine)=aib
shawnee=sjw
langue\ des\ signes\ finno-suédoise=fss
italien=it
copte=cop
babar\ (du\ Nord)=bcd
anglais\ (Irlande)=en
ghodoberi=gdo
slovaque=sk
algonquin=alq
haut-sorabe=hsb
chinois\ (Singapour)=zh
gothique=got
konkani=kok
napolitain=nap
zapotèque\ (Totomachapan)=zph
xhosa=xh
osque=osc
yoruba=yo
curonien=xcu
espagnol\ (Bolivie)=es
nanticoke=nnt
lingala=ln
tadjik=tg
vietnamien=vi
braj=bra
punique=xpu
bugi=bug
arabe\ (tunisien\ parlé)=aeb
comorien\ (Ngazidja)=zdj
tlingit=tli
gbaya=gba
kikuyu=ki
langue\ des\ signes\ zimbabwéenne=zib
zapotèque\ (Rincon\ du\ Sud)=zsr
unserdeutsch=uln
kimbundu=kmb
igbo=ig
fanti=fat
langue\ des\ signes\ française=fsl
arabe\ (séoudien\ parlé)=aec
zapotèque\ (Santiago\ Lapaguia)=ztl
bhili=bhb
catalan\ (Espagne)=ca
abun=kgr
carib(e)=car
sekani=sek
zapotèque\ (Xanaguia)=ztg
français\ (Luxembourg)=fr
susquehannock=sqn
arapaho=arp
peul=ff
afrihili=afh
lojban=jbo
delaware=del
pampangan=pam
pangasinan=pag
gwich´in=gwi
djaghataï=chg
wiyot=wiy
ndébélé\ du\ Nord=nd
guarani=gn
dioula=dyu
maltais=mt
russe=ru
créole\ arabe\ babalia=bbz
soundanais=su
pamlico=pmk
chibcha=chb
arabe\ (Jordanie)=ar
bas-silésien=sli
arabe\ (Egypte)=ar
grec\ ancien=grc
interlingue=ie
bosniaque=bs
interlingua=ia
kayapó=txu
arabe\ (marocain)=ary
bambara=bm
inupiaq=ik
arabe\ (Oman)=ar
malgache\ (betsimisaraka\ du\ Nord)=bmm
zapotèque\ (Loxicha)=ztp
quechua\ corongo=qwa
français\ (Canada)=fr
etchemin=etc
cimbrien=cim
azéri=az
rabha=rah
sami\ de\ Lule=smj
mongo=lol
ougaritique=uga
kom=kv
marathe=mr
zuni=zun
mongol=mn
zapotèque\ (Yatee)=zty
kotava=avk
frison\ (oriental)=frs
hawaïen=haw
rajasthani=raj
anglais\ (Philippines)=en
kitsai=kii
tindi=tin
créole\ anglais\ bahaméen=bah
kavalan=ckv
lombard=lmo
français\ (cajun)=frc
pachto=ps
espagnol\ (Porto\ Rico)=es
koumyk=kum
manda\ (Australie)=zma
ukrainien=uk
altaï\ (du\ Nord)=atv
tigré=tig
alémanique=gsw
loup\ b=xlb
lakota=lkt
oubykh=uby
khasi=kha
télougou=te
tsimshian=tsi
hinoukh=gin
ndébélé\ du\ Sud=nr
abkhaze=ab
(ancien)\ égyptien=egy
créole\ anglais\ belizéen=bzj
cayuga=cay
bouhide=bku
madourais=mad
polonais=pl
bulgare\ (Bulgarie)=bg
mohawk=moh
balinais=ban
arabe\ (judéo-tunisien)=ajt
gayo=gay
zapotèque\ (Amatlan)=zpo
loup\ A=xlo
slovène\ (Slovénie)=sl
anglais\ (Inde)=en
mendé=men
zapotèque\ (Güila)=ztu
altaï\ (du\ Sud)=alt
nyankolé=nyn
langue\ des\ signes\ brésilienne=bzs
efik=efi
hindi\ (Inde)=hi
hopi=hop
zapotèque\ antique=xzp
watubela=wah
chiquitano=cax
ko=fuj
carélien=krl
zapotèque\ (Pétapa)=zpe
malais\ (Bukit)=bvu
thaï\ (Thaïlande)=th
temne=tem
live=liv
karaim=kdr
haïtien=ht
powhatan=pim
luba-lulua=lua
nuer=nus
croate\ (Croatie)=hr
talysh=tly
zapotèque\ (mixtépèque\ San-Agustin)=ztm
norvégien\ nynorsk=nn
arabe\ (Emirats\ Arabes\ Unis)=ar
omaha-ponca=oma
nafaanra=nfr
lamba=lam
ingrien=izh
akkadien=akk
umbundu=umb
mandingue=man
mirandais=mwl
ludien=lud
iban=iba
indonésien=id
zapotèque\ (Yatzachi)=zav
roumain=ro
araméen=arc
zapotèque\ (Tlacolulita)=zpk
limbourgeois=li
créole\ afro-séminole=afs
xavánte=xav
bemba\ (République\ démocratique\ du\ Congo)=bmy
irlandais\ (Irlande)=ga
polabe=pox
sarsi=srs
soussou=sus
zandé\ (spécifique)=zne
sotho\ du\ Sud=st
franco-provençal=frp
(vieux)\ prussien=prg
haida=hai
lisu=lis
féroïen=fo
papiamento=pap
ottawa=otw
zoque\ (Raÿon)=zor
oïrat=xal
marvari=mwr
kekchi=kek
zapotèque\ (de\ l’Isthme)=zai
fon=fon
provençal\ ancien\ (jusqu'à\ 1500)=pro
lituanien=lt
lezghien=lez
arabe\ (Yémen)=ar
washo=was
créole\ anglais\ nicaraguais=bzk
assamais=as
zoque\ (Copainala)=zoc
khanty=kca
carolinien=cal
béna\ (Tanzanie)=bez
zapotèque\ (mazaltépèque)=zpy
cherokee=chr
malais\ négéri-sembilan=zmi
awadhi=awa
finnois\ (Finlande)=fi
ama\ (Papouasie-Nouvelle-Guinée)=amm
picte=xpi
palau=pau
anglais\ (Royaume-Uni)=en
tshangla=tsj
azéri\ (du\ Nord)=azj
zoulou=zu
baré=bae
zapotèque\ (Santa-Catarina\ Albarradas)=ztn
dinka=din
ga=gaa
anglais\ (Canada)=en
hiri\ motu=ho
mandar=mdr
anglais\ (Nouvelle-Zélande)=en
han=haa
langue\ des\ signes\ bolivienne=bvl
arabe\ (Dhofari)=adf
tswana=tn
aromoun=rup
arabe\ (Tunisie)=ar
zapotèque\ (Élotépèque)=zte
zapotèque\ (Aloapam)=zaq
sudovien=xsv
kutenai=kut
natchez=ncz
kirghize=ky
bébélé=beb
malgache=mg
malais\ (ambonais)=abs
wayana=way
mandchou=mnc
espagnol\ (Etats-Unis)=es
barijî=bjc
pohnpei=pon
arabe\ (tadjik)=abh
symboles\ Bliss=zbl
zapotèque\ (Quioquitani-Quiéri)=ztq
zapotèque\ (Ixtlan\ du\ Sud-Est)=zpd
occitan\ (après\ 1500)=oc
polonais\ (Pologne)=pl
comorien=swb
néo-araméen\ (occidental)=amw
baloutchi=bal
bouriate\ (Mongolie)=bxm
waiwai=waw
gongdouk=goe
langue\ des\ signes\ britannique=bfi
ekajuk=eka
sukuma=suk
amharique=am
hébreu\ (Israël)=iw
zapotèque\ (Zoogocho)=zpq
russe\ (Russie)=ru
niué=niu
arabe\ (Syrie)=ar
estonien=et
garifuna=cab
douala=dua
bali\ (République\ démocratique\ du\ Congo=bcp
kosrae=kos
ket=ket
choctaw=cho
arabe\ (lévantin\ du\ Sud)=ajp
norvégien\ (Norvège,Nynorsk)=no
sami\ du\ Sud=sma
catalan=ca
newari\ classique=nwc
samoan=sm
jaqaru=jqr
twi=tw
lahnda=lah
arabe\ (Liban)=ar
néerlandais=nl
espagnol\ (Costa\ Rica)=es
vieux\ norrois=non
erza=myv
sami\ du\ Nord=se
arménien=hy
abénaquis\ ouest=abe
sumérien=sux
ingouche=inh
kol\ (Cameroun)=biw
zapotèque\ (Santiago\ Xanica)=zpr
mingrélien=xmf
naxi=nbf
basa=bas
ticuna=tca
serbe\ (Serbie)=sr
Doungane=dng
kwadi=kwz
langue\ des\ signes\ australienne=asf
osage=osa
anglais\ (Malte)=en
bikol=bik
créole\ guyanais=gyn
lozi=loz
wyandot=wya
crow=cro
bassa\ (Nigéria)=bzw
routoul=rut
espagnol\ (Vénézuela)=es
shona=sn
kom\ (Cameroun)=bkm
(gaélique)\ irlandais=ga
serbo-croate=sh
tibétain\ (Amdo)=adx
arabe\ (algérien)=arq
bébéli=bek
macédonien\ (Macédoine)=mk
luo=luo
tchétchène=ce
arabe\ (omanais)=acx
tumbuka=tum
sidamo=sid
zapotèque\ (Coatlan)=zps
khinalough=kjj
slovène=sl
hmong=hmn
lunda=lun
kalmouk=xal
arabe\ (judéo-marocain)=aju
apache\ (occidental)=apw
bilé=bil
oriya=or
arabe\ (soudanais)=apd
potawatomi=pot
apache\ (Mescalero-Chiricahua)=apm
balotchî\ (oriental)=bgp
tolowa=tol
arabe\ (mésopotamien\ du\ Nord)=ayp
ibère=xib
thaï(landais)=th
vote=vot
rhéto-roman=rm
roumain\ (Roumanie)=ro
néerlandais\ moyen=dum
bina\ (Nigéria)=byj
kongo=kg
scot(s)=sco
langue\ des\ signes\ algérienne=asp
espagnol\ (Pérou)=es
népalais=ne
zaza=zza
angika=anp
dimili=zza
ao\ naga=njo
marshall=mh
langue\ des\ signes\ adamorobe=ads
vengo=bav
zapotèque\ (Yalalag)=zpu
arabe\ (Sanaani)=ayn
néo-araméen\ (assyrien)=aii
