#lng2name_ZH
英=en
拉丁=la
日=ja
汉=zh
法=fr
德=de
俄=ru
韩=ko
#Tue Apr 10 01:09:46 CEST 2012
康藏语=khg
噶拉塘-门巴语=kkf
古朝鲜语=oko
乌语=uuu
巴图语=btu
奇努克混合语=chn
曼西语=mns
斐济印度斯坦语=hif
英文\ (新西兰)=en
图鲁语=tcy
曼岛语=gv
日本语=ja
北卢尔语=lrc
塔加洛语=tl
瑞典文\ (瑞典)=sv
夏威夷皮钦手语=hps
基奧瓦语=kio
阿法尔语=aa
斯米伽联语=xzm
奇布查语=chb
乌利奇语=ulc
马拉雅拉姆语=ml
温达语=ve
索马利亚语=so
僧加罗语=si
苏库马语=suk
罗托卡特语=roo
闽东话=cdo
南艾马拉语=ayc
雪尔塔语=sth
康纳达语=kn
麻山北部苗语=hmp
日语=ja
中高棉语=km
泰文=th
丁卡语=din
仫佬语=mlm
宾夕法尼亚德语=pdc
土族语=mjg
拉脱维亚语=lv
特林吉特语=tli
犹太-波斯语=jpr
安多藏语=adx
塔希提语=ty
法文\ (法国)=fr
列托语=xrr
波斯语=fa
错那-门巴语=twm
古荷兰语=odt
皮克特语=xpi
佯僙语=tct
琉球语=ryu
中古亚美尼亚语=axm
京语=vi
弗拉尼语=ff
彼切尼克语=xpc
巴斯克语=eu
奇图姆布卡语=tum
萨霍语=ssy
弗留利语=fur
史兴语=sxg
阿伊努语=ain
纳瓦特尔语=nah
哈梯语=xht
中纳瓦特尔语=nhn
徽語=czh
孔卡尼语=kok
巴里语=bfa
崩尼-博嘎尔语=adi
库洛年语=xcu
马拉瑙语=mrw
草苗语=cov
青苗话=hnj
国际语（国际语A）=ia
南恩德贝勒语=nr
西双版纳傣语=khb
傣仂语=khb
色雷斯语=txh
图尔卡纳语=tuv
蒙古布里亚特语=bxm
阿古尔语=agx
瑞士法语区手语=ssr
古代利古里亚语=xlg
土耳其语=tr
德文\ (卢森堡)=de
象雄语=xzh
纳卢语=naj
法文\ (卢森堡)=fr
庇卡底语=pcd
小花苗语=sfm
马拉比语=mra
华语=zh
普罗维登西亚手语=prz
罗马尼亚手语=rms
古阿拉米语=oar
埃翁多语=ewo
艾努语=aib
波兰文\ (波兰)=pl
利比亚阿拉伯语=ayl
加勒比印度斯坦语=hns
阿拉伯文\ (摩洛哥)=ar
奇尔科廷语=clc
德昂语=pll
阿尔巴尼亚语=sq
卢萨语=lus
怒语=nun
国头琉球语=xug
林堡语=li
古肯特手语=okl
埃克丘克语=eka
西班牙文\ (秘鲁)=es
斯特法伦语=wep
哈卡斯语=kjh
格陵兰语=kl
苏美尔语=sux
阿拉伯文\ (叙利亚)=ar
智利手语=csg
大平原印地安手语=psd
法耳次德语=pfl
科普特语=cop
普鲁士语=prg
锡伯语=sjo
莫语=mkg
宿务语=ceb
法文\ (比利时)=fr
松巴哇语=smw
拉迪恩语=lld
惠水北部苗语=hmi
瓦伦西亚手语=vsv
曼尼普尔语=mni
炯奈布努语=pnu
西红苗话=mmr
保加利亚手语=bqn
豆兰阿美语=ais
苏格兰盖尔语=gio
波罗的罗姆语=rml
冰岛语=is
塔巴萨兰语=tab
门德语=men
维斯提奈语=xvs
西班牙文\ (哥伦比亚)=es
巴尔虎布里亚特语=bxu
西部现代亚拉姆语=amw
夏威夷克里奥尔英语=hwc
撒丁语,\ 萨丁尼亚语=sc
法语=fr
芒戈语=lol
兰戈语=laj
波拉布语=pox
科米语=kv
邦板牙语=pam
律勒欧-萨米语=smj
西徐亚语=xsc
乌鲁姆语=uum
西斐济语=wyy
卡拉卡尔帕克语=kaa
圭亚那克里奥尔法语=gcr
罗曼什语=rm
巴什噶尔语=ba
北萨莫斯语=se
拉祜语=lhu
印度手语=ins
北弗里西语=frr
哥伦打洛语=gor
科里亚克语=kpy
阿拉贡语=an
河内手语=hab
猫雾语=bzg
犹太-法语=zrp
寮国语=lo
契丹语=zkt
高棉语=km
斯瓦希里语=swh
爱尔兰手语=isg
安博语=amb
中艾马拉语=ayr
马尔瓦利语=mwr
逻辑语=jbo
土库曼语=tk
马萨伊语=mas
钵罗钵语=pal
尼日利亚富拉语=fuv
阿法尔语l=aa
玻利维亚手语=bvl
车臣语=ce
喜界岛琉球语=kzg
晉語=cjy
古藏语=otb
南非荷兰语=af
马都拉语=mad
密岔彝语=yiq
沙阿鲁阿语=sxr
帕尔基语=pci
布列塔尼语=br
古威尔士语=owl
瓦乡话=wxa
中古威尔士语=wlm
诺里语=nrc
托克皮辛语=tpi
撒丁语=sc
特克斯和凯科斯克里奥尔英语=tch
奥塞梯语=os
秘鲁手语=prl
卢维语（象形文字）=hlu
卡拉嘎斯语=kim
索马里语=so
海地克里奥尔语=ht
克蔑语=kfj
魁北克手语=fcs
意大利文\ (意大利)=it
西班牙文\ (萨尔瓦多)=es
坎佯语=ksu
阿布哈西亚语‎=ab
舍弥来语=sza
拉丁语=la
比哈尔语=bh
塔塔尔语=tt
哥德语=got
巴尔扎尼犹太教亚拉姆语=bjf
阿瓦蒂梅语=avn
萨丁尼亚-萨萨里语=sdc
傣哪语=tdd
纳吉迪阿拉伯语=ars
太平洋湾尤皮克语=ems
索宁克语=snk
塞尔维亚文\ (塞尔维亚及黑山)=sr
岱依语=tyz
北萨米语=se
傣龙语=thi
佛罗语=vro
瑟罗尼亚语=sxl
古典曼底安语=myz
西占语=cja
艾米利亚-罗马涅语=eml
赞德语=zne
纳瓦荷语=nv
八排瑶语=bpn
伊犁土尔克语=ili
西方国际语=ie
瓦利斯语=wls
浪峨语=mhx
古撒克逊语=osx
斐济印地语=hif
西兰语=zea
胡里语=xhu
高地瑶话=ium
泰文\ (泰国,TH)=th
保加利亚文\ (保加利亚)=bg
英文=en
幽语=ee
傣纳语=tdd
南卢尔语=luz
斯洛维尼亚语=sl
艾利米亚语=xly
山外高卢语=xtg
勒期语=lsi
怒苏语=nuf
伊博语=ig
阿拉伯文\ (黎巴嫩)=ar
鲁凯语=dru
阿拉伯文\ (沙特阿拉伯)=ar
迪维希语=dv
上寨语=jih
乍得手语=cds
巴沙语=bsq
台湾手语=tss
唔奈布努语=bwn
萨德里语=sck
苏里南汤加语=srn
麻山南部苗语=hma
拉兹语=lzz
佤语=wbm
意大利文\ (瑞士)=it
西西里语=scn
阿尔及利亚撒哈拉阿拉伯语=aao
莫西语=mos
葡萄牙文\ (葡萄牙)=pt
粵語=yue
科萨语=xh
宗喀语=dz
阿罗马尼亚语=rup
阿尔及利亚阿拉伯语=arq
花剌子模语=zkh
契维语=tw
法国手语=fsl
古突厥语=otk
海防手语=haf
斯洛伐克语=sk
阿拉伯语=ar
巴西手语=bzs
右江壮语=zyj
萨丁尼亚-坎皮达诺语=sro
斯洛伐克文\ (斯洛伐克)=sk
凯米-萨米语=sjk
捷克语=cs
丹麦文=da
日德兰语=jut
雅格诺比语=yai
巴哼语=pha
鄂温克语=evn
艾马拉语=ay
晤鲁都语=ur
默切诺语=mhn
粟特语=sog
俄文\ (俄罗斯)=ru
加泰隆语=ca
中比科尔语=bcl
拉帕努伊语=rap
秳语=zko
阿迪格语=ady
以色列手语=isr
萨比尼语=sbv
桑达韦语=sad
白苗话=mww
哈扎尔语=zkz
古泰米尔语=oty
翁本杜语=umb
德文\ (德国)=de
克伦地语=rn
俄语=ru
森林西班牙语=spq
亚美尼亚语=hy
吉尔伯特语=gil
阿拉米语=arc
哈尼语=hni
安吉卡语=anp
米南卡保语=min
丘克语=chk
孟语=mnw
达让-僜语=mhu
西班牙文\ (美国)=es
英文\ (菲律宾)=en
中寨语=jiq
布农语=bnn
倮罗颇彝语=ycl
荼隆语=try
纳西语=nbf
苗语=hmn
莫克沙语=mdf
古典希腊语=grc
罗姆语=rom
三宝颜共同语=cbk-zam
新西兰手语=nzs
加罗语=grt
蒙古语=mn
牙买加国家手语=jcs
梅诺米尼语=mez
犹加敦马雅语=yua
阿拉伯文\ (卡塔尔)=ar
西班牙文\ (波多黎哥)=es
西班牙文\ (危地马拉)=es
立陶宛语=lt
加拉提亚语=xga
布拉灰语=brh
峇里语=ban
西班牙文\ (乌拉圭)=es
伊纳里-萨米语=smn
沃提克语=vot
摩杰语=mjz
上撒克逊语=sxu
伊巴雅语=ivb
山地马里语=mrj
立陶宛手语=lls
贡德语=gon
托克劳语=tkl
克里语=cr
南斯拉夫手语=ysl
粤语=zh-yue
瓦龙语=wa
荷兰低地萨克逊语=nds-nl
东奥罗莫语=hae
川黔滇苗话=cqd
哈萨克语=kk
中西奥罗莫语=gaz
豪萨手语=hsl
大夏语=xbc
北皮赛恩语=nrp
依善泰语=tts
北索托语=nso
閩中話=czo
西班牙文\ (巴拿马)=es
夏威夷语=haw
钦布语=kue
吉普赛语=rom
古马拉地语=omr
依地语=yi
日本手语=jsl
白俄罗斯语（1933年前）=be-x-old
白马语=bqh
古教会斯拉夫语=cu
桂北壮语=zgb
凯尔特伊比利亚语=xce
依努庇克语=ik
中尤皮克语=esu
科拉米语=kfb
古典蒙古语=cmg
犹太-斯拉夫语=czk
泰国手语=tsq
西马里语=mrj
巽他语=su
富拉语=ff
爱沙尼亚文\ (爱沙尼亚)=et
卡伦津语=kln
上古漢語=och
威尔士罗姆语=rmw
黑傣语=kyp
柳黔壮语=zlq
回鹘语=oui
库尔施语=ksh
洛齐语=loz
乌兹别克阿拉伯语=auz
摩尔多瓦手语=vsi
埃及语=egy
砚广壮语=zhn
克里克语=mus
东部裕固语=yuy
奥斯坎语=osc
宽话=xnh
奥隆-萨德里语=sdr
纳米比亚手语=nbs
冲永良部岛琉球语=okn
威尔士语=cy
比科尔语=bik
阿巴札语=abq
古弗里西亚语=ofs
卡那卡那布语=xnb
尼泊尔语=ne
基尼阿万达语=rw
马尔他语=mt
特立尼达和多巴哥手语=lst
坦米尔语=ta
桑戈语=sg
加罗林语=cal
亚美尼亚手语=aen
尤卡坦玛雅手语=msd
爱尔兰文\ (爱尔兰)=ga
牙买加克里奥尔英语=jam
义都语=clk
澳大利亚原住民手语=asw
摩尔多瓦语=mo
景颇语=kac
努特卡语=noo
标准马来语=zsm
伊斯特拉-罗马尼亚语=ruo
多格里布语=dgr
朝鲜语=ko
丰语=fon
排湾语=pwn
东尼苏语=nos
日文\ (日本)=ja
威尔斯语=cy
西班牙文\ (洪都拉斯)=es
古西班牙语=osp
明打威语=mwv
加纳手语=gse
奇族语=tw
楞高语=ren
南马克萨斯语=mqm
赛夏语=xsy
冰岛文=is
巴萨语=bas
阿乔利语=ach
佛兰芒语=vls
苦聪语=lkc
克劳语=cro
博特利赫语=bph
义都-珞巴语=clk
湘語=hsn
德国手语=gsg
南萨米语=sma
艾通语=aio
拉托维亚文(列托)\ (拉脱维亚)=lv
巴达加语=bfq
内蒙古话=mvf
西方国际语（国际语E）=ie
苏苏语=sus
印地文\ (印度)=hi
达基亚语=xdc
鄂罗奇语=oac
特列纳语=ter
白俄罗斯文\ (白俄罗斯)=be
标准阿拉伯语=arb
呼罗珊土耳其语=kmz
阿姆哈拉语=am
越南文\ (越南)=vi
伊多语=io
南梭苏语=st
埃及手语=esl
阿拉伯文\ (也门)=ar
卡威语=kaw
荷兰语=nl
波多黎各手语=psl
摩揭陀语=mag
英文\ (爱尔兰)=en
萨丁尼亚-劳古多罗语=src
英文\ (印度)=en
古马其顿语=xmk
马其顿文\ (马其顿王国)=mk
焉耆语=xto
塔马齐格特语=tzm
奥罗莫语=om
僧伽罗语=si
韩国手语=kvk
瑞士德语区手语=sgg
阿富汗手语=afg
比什奴普莱利亚-曼尼浦尔语=bpy
阿勒曼尼语=als
南黎凡特阿拉伯语=ajp
提瓦语=lax
鹆语=yuu
贡耶玛语=kj
芬兰-瑞典手语=fss
那乃语=gld
东吐火罗语=xto
塞尔维亚-克罗地亚语=sh
卢塔语=rut
低地琼塔尔语=clo
豪萨语=ha
比斯拉马语=bi
布里亚特语=bxr
西吐火罗语=txb
法兰克-普罗旺斯语=frp
尼加拉瓜手语=ncs
萨丁尼亚-加卢拉语=sdn
西班牙文\ (西班牙)=es
曼底安语=mid
卡拜尔语=kab
恩东加语=ng
傣担语=blt
乌克兰手语=ukl
泰卢固语=te
斯洛文尼亚语=sl
比尔语=bhb
塞雷尔语=srr
乌都语=ur
巴吉尔米语=bmi
楚利姆语=clw
古书面卫拉特语=xwo
英文\ (新加坡)=en
赞比亚手语=zsl
莫哈维语=mov
奇卢伯语=lua
卡舒比语=csb
德文\ (奥地利)=de
邹语=tsu
埃兰语=elx
国际手语=ils
村语=cuq
赫雷罗语=hz
波兰语=pl
多米尼加手语=doq
东富图纳语=fud
泰米尔语=ta
塔吉克阿拉伯语=abh
柳江壮语=zlj
八重山琉球语=rys
迦南语=czk
西富图纳语=fut
犹太-阿拉伯语=jrb
凯楚亚语=qu
伊卢拉语=iru
南侗语=kmc
古爪哇语=kaw
与论岛琉球语=yox
图瓦语=tyv
巴克提尔利语=bqi
撒尼语=ysn
内慈佩尔塞语=nez
罗马尼亚语=ro
西班牙文\ (尼加拉瓜)=es
考利茨语=cow
越南语=vi
瑙鲁语=na
卡姆巴语=kam
加大巴语=gau
旁狄希腊语=pnt
瑞士意大利语区手语=slf
奥拉瑞语=gdb
澳大利亚手语=asf
阿塞拜疆语=az
萨尔瓦多手语=esn
宋加语=ts
塞尔维亚语=sr
亻革家语=hmj
米底语=xme
布勒加尔语=xbo
石语=skb
西波斯语=pes
南塞索托语=st
巴布亚皮钦语=tpi
拉基语=lbt
义大利语=it
挪威文\ (挪威,Nynorsk)=no
斯里兰卡克里奥尔马来语=sci
东部彝语=yit
利比亚手语=lbs
喀克其奎语=cak
南倮罗颇彝语=ysp
俄罗斯手语=rsl
哥斯达黎加手语=csr
古康沃尔语=oco
卢维语（楔形文字）=xlu
埃桂语=xae
中古康沃尔语=cnx
奥萨格语=osa
布依语=pcc
左江壮语=zzj
洛米藏语=lhm
北阿塞拜疆语=azj
大理白语=bfs
瓦肖语=was
澳门土语=mzs
萨丁尼亚语=sc
北侗语=doc
嘉绒语=jya
傣泐语=khb
临高语=onb
马萨葡萄园手语=mre
英文\ (马耳他)=en
邵语=ssf
伊杰耳缅语=itl
摩押语=obm
维尔京群岛克里奥尔英语=vic
捷克文=cs
西班牙文\ (委内瑞拉)=es
布利斯符号=zbl
普格语=puk
伊努特语=iu
卡帕多细亚希腊语=cpg
惠水西南苗语=hmh
邦阿西楠语=pag
邕南壮语=zyn
马拉地语=mr
五色话=eee
威尼托语=xve
布鲁沙斯基语=bsk
库臣语=gwi
简单英语=simple
班巴拉语=bm
国际语E=ie
马赛语=byq
南索托语=st
卫拉特语=xal
仓洛-门巴语=tsj
国际语A=ia
法文\ (瑞士)=fr
哈里亚纳语=bgc
印度尼西亚手语=inl
伊利比亚语=xib
塞海蒂语=syl
印古什语=inh
俄文=ru
马约语=mfy
希伯来文\ (以色列)=iw
希腊文\ (希腊)=el
加泰罗尼亚手语=csc
卢旺达语=rw
中马来语=pse
特威语=tw
扎巴语=zhb
科莫克斯语=coo
四川彝语=ii
古希伯来语=hbo
大花苗语=hmd
科西嘉语=co
哈恩语=haa
南阿尔泰语=alt
黔东北部苗语=hea
瓦伊语=vai
斯瓦西里语=swh
宿雾语=ceb
阿瓦德语=awa
巴布拉语=ppu
古爱尔兰语=sga
噶玛兰语=ckv
中古爱尔兰语=mga
爱沙尼亚手语=eso
约鲁巴语=yo
雅库特语=sah
南羌语=qxs
邕北壮语=zyb
金平傣语=twh
吉拉克语=glk
波斯湾阿拉伯语=afb
撒拉语=slr
图罗尤语=tru
库梅克语=kum
印度尼西亚文\ (印度尼西亚)=in
克木语=kjg
沃洛夫语=wo
唐米语=thf
路易斯安那州法语=frc
古匈牙利语=ohu
埃文语=eve
立陶宛文=lt
国际语=ia
西班牙语=es
泰姆奈语=tem
瓦赖语=war
素拉杰普尔语=sjp
香港手语=hks
平地瑶话=mji
诺维亚语=nov
莆仙話=cpx
西拉雅语=fos
修士手语=mzg
尼扬韦齐语=nym
科塔语=kfe
藻敏语=bpn
葡萄牙文\ (巴西)=pt
犹太－格鲁吉亚语=jge
西库尔语=scx
中古英语=enm
希里木托语=ho
中尼科巴语=ncb
阿里语=aac
莱兹金语=lez
傣曼语=tmp
马绍尔语=mh
波尼语=paw
吉大港语=ctg
乔克托语=cho
侬语=nut
古典尼瓦尔语=nwc
腓尼基语=phn
希腊文\ (塞浦路斯)=el
贵阳北部苗语=huj
北羌语=cng
卢巴-卢拉语=lua
绍尔语=cjs
纳木义语=nmz
伊多马语=idu
渥鲁夫语=wo
维吾尔语=ug
中部彝语=ycl
恩加语=enq
隆韦语=ngl
中库尔德语=ckb
乌撒彝语=yig
古诺尔斯语=non
埃卜拉语=xeb
圣卢西亚克里奥尔法语=acf
西夏语=txg
芬兰文\ (芬兰)=fi
卢瓦勒语=lue
德昂语汝买方言=rbb
诺鲁语=na
马林德语=mrz
博嘎尔-珞巴语=adi
乔治亚语=ka
马其顿语=mk
刚果斯瓦希里语=swc
布比语=buw
匈牙利手语=hsh
葡萄牙语=pt
纳罗语=ylo
淡米尔语=ta
利古里亚语=lij
菲律宾语=fil
突尼斯手语=tse
贵阳西南苗语=hmg
犹太-克里米亚鞑靼语=jct
柔若语=zal
哲尔马语=dje
埃菲克语=efi
挪威文\ (挪威)=no
索科特拉语=sqt
班尤马山语=map-bms
南扎扎其语=diq
伦巴底日耳曼语=lng
卡拉莫琼语=kdj
阿萨姆语=as
北高棉语=kxm
萨马利亚阿拉米语=sam
柯尔克孜语=ky
提格利尼亚语=ti
刚果语=kg
达尔哈特语=drh
德之岛琉球语=tkn
朝鲜文=ko
卢伊塞诺语=lui
古普罗旺斯语=pro
载瓦语=atb
北土家语=tji
锡达莫语=sid
愒语=ket
科曼切语=com
巴利语=pi
雅比姆语=jae
卡布列语=kab
古格鲁吉亚语=oge
米德勒语=mai
美国手语=ase
东乡语=sce
托斯克阿尔巴尼亚语=als
中古尼瓦尔语=nwx
尼日利亚手语=nsi
豪尼语=how
哈拉吉语=klj
北奄美琉球语=ryn
希利盖农语=hil
土阿莫土语=pmt
马来语=ms
米克马克语=mic
塞巴语=xsa
拉迪诺语=lad
奥斯曼土耳其语=ota
攸乐基诺语=jiu
阿昌语=acn
彭戈语=peg
中普什图语=pst
坤语=kkh
闽南话=zh-min-nan
塞拉利昂手语=sgx
平地马里语=mhr
加泰罗尼亚语=ca
清迈手语=csd
库特内语=kut
尼泊尔手语=nsp
巴尔干罗姆语=rmn
本巴语=bem
西弗里西亚语=fy
于阗语=kho
汉语=zh
龟仑语=uun
夏延语=chy
利沃尼亚语=liv
姆布姆语=mdd
萨波特克语=zap
皮拉罕语=myp
新共同语言=lfn
喀尔巴阡罗姆语=rmc
瑞士德语=gsw
上索布语=hsb
苏阿迪特语=sdt
连山壮语=zln
杜亚拉语=dua
古巴手语=csf
图瓦卢语=tvl
标话=byk
拉珈语=lbc
中文=zh
荷兰文=nl
乔克维语=cjk
乌兹别克语=uz
盖格阿尔巴尼亚语=aln
康沃尔语=kw
侥语=nyw
奥地利-巴伐利亚语=bar
布甘语=bbh
东加语=to
泰文\ (泰国)=th
哈扎语=hts
梅戈来诺-罗马尼亚语=ruq
角苗话=hrm
乌尔都语=ur
北普米语=pmi
提格雷语=tig
罗泊河苗语=hml
壮语=za
克佩勒语=kpe
莫霍克语=moh
中文\ (新加坡)=zh
冰岛文\ (冰岛)=is
雅伦卡语=yal
克里米亚鞑靼语=crh
克什米尔语=ks
古英语=ang
哲纳加语=zen
北乌兹别克语=uzn
阿拉伯文\ (阿尔及利亚)=ar
西班牙文\ (玻利维亚)=es
南俾路支语=bcc
拉亨达语=lah
阿拉帕霍语=arp
隆达语=lun
纳瓦霍语=nv
标藻语=bje
塔马舍克语=tmh
閩北語=mnp
皮埃蒙特语=pms
惠水东部苗语=hme
古吉拉特语=gu
库马利语=kyw
亚维语=mfa
回辉话=huq
卑南语=pyu
蒙达里语=unr
迈锡尼希腊语=gmy
布鲁夏斯基语=bsk
布-瑙布努语=bwx
日文\ (日本,JP)=ja
达悟语=tao
补远基诺语=jiy
哥伦比亚手语=csn
白拉基语=lwh
冻土埃内茨语=enh
藏语=bo
史拉维语=den
东意第绪语=ydd
洛雷托-乌卡亚利西班牙语=spq
卢森堡语=lb
雪兰莪手语=kgi
亚拉冈语=an
沙维亚语=shy
古典纳瓦特尔语=nci
东弗里西亚语=frs
西意第绪语=yih
列兹金语=lez
文麻壮语=zhd
密尼安语=inm
阿拉伯文\ (利比亚)=ar
马拉加西语=mg
莫札拉布语=mxi
罗马尼亚文=ro
加泰隆尼亚语=ca
蒙达语=unx
巴克特里亚语=xbc
越南文=vi
曼丁哥语=mnk
萨萨克语=sas
希伯来语=he
马鲁西尼语=umc
麻山中部苗语=hmm
碧江白语=bfc
查加台语=chg
中古蒙古语=xng
厄瓜多尔手语=ecs
爱尔兰语=ga
意大利语=it
英文\ (南非)=en
门诺低地德语=pdt
卡斯卡语=kkz
黔东南部苗语=hms
东红苗话=muq
雅浦语=yap
梅格列尔语=xmf
尔龚语=ero
丹麦文\ (丹麦)=da
东恩加达语=nea
西旁遮普语=pnb
匈牙利语=hu
卢奥语=luo
中古法语=frm
中文\ (台湾地区)=zh
格林纳达克里奥尔英语=gcl
提格里尼亚语=ti
老挝手语=lso
独龙语=duu
东占语=cjm
文达语=ve
芳语=fan
阿美语=ami
塞尔维亚文\ (塞尔维亚)=sr
卡西语=kha
姆本杜语=kmb
伊努伊特语=iu
仙岛语=xia
埃斯特雷马杜拉语=ext
法拉语=fax
民大威语=mwv
科达古语=kfa
马耳他文\ (马耳他)=mt
特立尼达克里奥尔英语=trf
沃尔西语=xvo
不丹语=dz
科斯拉伊语=kos
别姆巴语=bem
古日语=ojp
比林语=byn
卡纳达语=kn
富尔语=fvr
萨那阿拉伯语=ayn
埃及阿拉伯语=arz
赛德克语=trv
阿坎语=ak
丹麦手语=dsl
德顿语=tet
塞尔维亚文\ (波斯尼亚和黑山共和国)=sr
哈特德语=geh
爱沙尼亚语=et
中孟语=cmo
努埃尔语=nus
犹太-塔特语=jdt
大溪地语=ty
桑孔语=sgk
吉尔吉斯语=ky
犹太-西班牙语=lad
皮特-萨米语=sje
沙特弗里西语=stq
奥克西坦语=oc
英文\ (英国)=en
北黎凡特阿拉伯语=apc
塔特语=ttt
查莫罗语=ch
阿细语=yix
瑞典手语=swl
桑塔利语=sat
贵阳南部苗语=hmy
西莱基语=skr
北贡德语=gno
乌德穆尔特语=udm
科瓦语=khw
安迪语=ani
宗加语=ts
撒梅语=smh
基切语=quc
胡志明市手语=hos
科摩罗语=swb
查马拉尔语=cji
纳斯卡皮语=nsk
北恩德贝勒语=nd
伊斯特拉语=ist
纽埃语=niu
拉脱维亚语方言=ltg
卢格巴拉语=lgg
克罗地亚文\ (克罗地亚)=hr
菲律宾手语=psp
现代希腊语=el
坎巴语=kam
拿坡里语=nap
卡约语=gax
古高地德语=goh
中古高地德语=gmh
古赫梯语=oht
摩洛哥阿拉伯语=ary
托达语=tcx
瓦罕语=wbl
查法蒂语=zrp
嘎嘎乌孜语=gag
约旦手语=jos
文言文=zh-classical
拉哈语=lha
东俾路支语=bgp
哈德拉米语=xhd
中古朝鲜语=okm
喀什米尔语=ks
惠水中部苗语=hmc
北尤卡吉尔语=ykg
俄罗斯布里亚特语=bxr
布兴话=bgk
布拉吉语=bra
五屯话=wuh
西俾路支语=bgn
拉托维亚文(列托)=lv
意第绪语=yi
兰巴语=lam
博杰普尔语=bho
夜郎语=yrn
古法兰克语=frk
孔达语=kfc
马耳他语=mt
鄂伦春语=orh
拉克语=lbe
奥克西唐语=oc
南土家语=tjs
爪哇语=jv
尼瓦尔语=new
朝鲜文\ (韩国)=ko
德靖壮语=zyg
墨西哥手语=mfs
低地撒克逊语=nds
马来西亚手语=xml
比斯拉玛语=bi
聪加语=ts
龟兹语=txb
塞尔库普语=sel
掸语=shn
图木舒克语=xtq
卡多语=ktp
达戈姆巴语=dag
古曼尼普尔语=omp
扎扎其语=zza
南尼科巴语=nik
哈勒尔语=har
伊洛卡诺语=ilo
尼泊尔库鲁克语=kxl
书面挪威语=nb
古典叙利亚语=syc
阿卡德语=akk
库纳马语=kun
波纳佩语=pon
望加锡语=mak
洪雅语=ppu
马其顿-罗马尼亚语=rup
旁遮普语=pa
西里西亚语=szl
低地西里西亚语=sli
布里多尼语=br
萨瓦拉语=srb
拉祜纳语=lhu
恩加达语=nxg
中古荷兰语=dum
斯瓦特语=ss
马恩岛语=gv
斯科特-萨米=sms
白俄罗斯语=be
埃塞俄比亚手语=eth
中国手语=csl
Vlax\ 罗姆语=rmy
南库尔德语=sdh
阿布安语=abn
保加利亚语=bg
恩敦加语=ng
马其顿文=mk
康瓦尔语=kw
伯利兹克里奥尔英语=bzj
碧约语=byo
古法语=fro
哥特语=got
美索不达米亚阿拉伯语=acm
史瓦济兰语=ss
比塔拉语=brt
戈尔德语=gld
古阿瓦尔语=oav
莫桑比克手语=mzy
罗图马语=rtm
森林埃内茨语=enf
芳蒂语=fat
瓦尔瑟语=wae
乌德语=ude
基库尤语=ki
南普米语=pmj
帕图语=ps
线形文字A=lab
古缅甸语=obr
阿维坎语=avi
萨摩亚语=sm
库卢克语=kru
耶波列语=vep
塔加拉语=tl
拉脱维亚手语=lsl
俄都语=tyh
昆雅语=qya
东红水河壮语=zeh
吕底亚语=xld
巴什基尔语=ba
新加坡手语=sls
蒙戈语=lol
巴亚语=gba
格曼-僜语=mxj
捷克文\ (捷克共和国)=cs
重安江苗语=hmj
西班牙文\ (智利)=es
莫图语=meu
古布列塔尼语=obt
马尔西语=ims
金门话=mji
科米-彼尔米亚克语=koi
瓦隆语=wa
古叙利亚语=syr
客家话=hak
罗马尼亚文\ (罗马尼亚)=ro
乌拉圭手语=ugy
西台语=hit
危地马拉手语=gsm
阿哲语=yiz
古典克丘亚语=qwc
法文\ (加拿大)=fr
德昂语梁方言=ril
冰岛手语=icl
瑞典语=sv
阿拉伯文\ (阿曼)=ar
汪达尔语=xvn
孚泰语=pht
中古低地德语=gml
西班牙文\ (厄瓜多尔)=es
加泰罗尼亚文=ca
北阿尔泰语=atv
南普什图语=pbt
俾路支语=bal
库德语=ku
阿根廷手语=aed
伊隆戈语=hil
汤加语=to
新斯科舍手语=nsr
几内亚手语=gus
布朗语=blr
伊巴丹语=ivv
西班牙文\ (阿根廷)=es
尼日尔中-东部富拉语=fuq
土耳其手语=tsm
荷兰手语=dse
辛布里语=cim
阿拉伯文\ (阿拉伯联合酋长国)=ar
弗里西亚语=fy
卡什加语=qxq
撒马利亚语=smp
海达语=hai
厄尔兹亚语=myv
水语=swi
奥塞提语=os
希里莫图语=ho
古典亚美尼亚语=xcl
乌干达手语=ugn
雅基马语=yak
肯尼亚手语=xki
尼斯语=yso
澳大利亚克里奥尔语=rop
埃维语=ee
伊努必语=ik
戈多贝蒂语=gdo
卢森尼亚语=rue
迈蒂利语=mai
汤加语\ (汤加岛)=to
吉库尤语=ki
马林克语=man
毛南语=mmd
阿拉伯文\ (巴林)=ar
阿布哈兹语=ab
迪尤拉语=dyu
达尔马提亚语=dlm
乌克兰文\ (乌克兰)=uk
帕埃利尼语=pgn
阿卢尔语=alz
卢干达语=lg
阿弗里希利语=afh
犹太-意大利语=itk
南玻利维亚克丘亚语=quh
洪都拉斯手语=hds
加泰罗尼亚文\ (西班牙)=ca
尼扬贾语=ny
卡巴尔达语=kbd
委内瑞拉手语=vsl
吴语=wuu
中古漢語=ltc
林格拉语=ln
马孔德语=kde
齐切瓦语=ny
乌克兰语=uk
波兰手语=pso
沃拉普克语=vo
帕皮亚门托语=pap
阿拉伯文\ (科威特)=ar
巴哈布央语=yha
埃多姆语=xdm
古波斯语=peo
恰蒂斯加尔语=hne
巴拿马手语=lsp
帛琉语=pau
阿德勒语=ade
斯瓦比亚语=swg
芒加莱语=mqy
加茂语=jio
安提瓜和巴布达克里奥尔英语=aig
东马里语=mhr
路易斯安那克里奥尔法语=lou
伊利里亚语=xil
祖鲁语=zu
苏格兰语=sco
拉祜西语=lhi
梵语=sa
诺恩语=nrn
克罗地亚语=hr
塞拉利昂克里奥尔语=kri
霍屯督语=naq
尼亚斯语=nia
坦桑尼亚手语=tza
科尔库语=kfq
凯达格兰语=kae
奥内达语=one
南贡德语=ggo
瓜拉尼语=gn
辛达林=sjn
加勒比语=car
斐济语=fj
钦西安语=tsi
北扎扎其语=kiu
维鲁语=vro
皮特凯恩-诺福克语=pih
托莱语=ksd
亚东语=gro
他加禄语=tl
恩济马语=nzi
瓦伦西亚语=ca
南尤卡吉尔语=yux
希伯来文=iw
穆萨斯语=smm
马耳他手语=mdl
官話=cmn
印度尼西亚语=id
诺曼语=nrm
巴基斯坦手语=pks
克罗埃西亚语=hr
威尼斯语=vec
意大利文=it
帕劳语=pau
洛格巴语=lgq
宋语=soa
德文\ (瑞士)=de
古努比亚语=onw
韩语=ko
奥利亚语=or
马拉提语=mr
挪威语=no
西克西卡语=bla
奇帕瓦语=ciw
潘奇帕尔干语=tdb
宽亚玛语=kj
匈牙利文=hu
波斯尼亚语=bs
吉利亚克语=niv
古俄语=orv
阿拉伯文\ (突尼斯)=ar
乌加里特语=uga
马库阿语=vmw
毛利语=mi
女真语=juc
意第绪手语=yds
沙特阿拉伯手语=sdl
巴厘语=ban
雷布查语=lep
蒂夫语=tiv
楚科奇语=ckt
康家语=kxs
古孟语=omx
巴格瓦拉尔语=kva
吉兹语=gez
里昂手语=lsg
科米-兹梁语=kpv
涅吉达尔语=neg
马迪语=grg
卢西塔尼亚语=xls
嘉莱语=jra
芒贝图语=mdj
坎伯兰语=xcb
荷兰文\ (比利时)=nl
法罗语=fo
贝扎语=bej
胡帕语=hup
库兰科语=knk
达斡尔语=dta
孟加拉语=bn
德宏傣语=tdd
库伊语=kxu
世界语=eo
泰雅语=tay
西班牙手语=ssp
修纳语=sn
诺盖语=nog
贛語=gan
卡尔梅克语=xal
满语=mnc
浪速语=mhx
西班牙文\ (哥斯达黎加)=es
Banjar语=bjn
立陶宛文\ (立陶宛)=lt
加利西亚语=gl
达科他语=dak
拉贾斯坦语=raj
红金傣语=tiz
客家話=hak
南阿塞拜疆语=azb
俫语=ply
下索布语=dsb
拉罗汤加语=rar
伦巴底语=lmo
河皮语=hop
阿拉伯文\ (苏丹)=ar
意大利手语=ise
斯里兰卡手语=sqs
纳奈语=gld
加语=gaa
察合台语=chg
阿瓦尔语=av
多格拉语=doi
摩洛哥手语=xms
优诺布努语=buh
津巴布韦手语=zib
泰语=th
基隆迪语=rn
巴马科手语=bog
阿基坦语=xaq
波士尼亚语=bs
仓洛语=tsj
克林贡语=tlh
希腊手语=gss
捷克手语=cse
英文\ (澳大利亚)=en
喀喇汗语=xqa
盎格鲁-诺曼语=xno
葡萄牙手语=psr
恩加拉语=nud
阿劳坎语=arn
布拉语=bxd
亚齐语‎=ace
巴列丁奈特德语=pfl
库尔德语=ku
马达加斯加语=mg
祖尼语=zun
达尔格瓦语=dar
畲语=shx
博多语=brx
傈僳语=lis
贝贾语=bej
马加赫语=mag
芬兰语=fi
尼奥罗语=nyo
波斯手语=psc
阿非利堪斯语=af
切罗基语=chr
辛德语=sd
吕基亚语=xlc
危地马拉克里奥尔法语=gcf
中红水河壮语=zch
阿维斯陀语=ae
夏尔巴语=xsr
穆斯科格语=mus
瓦拉莫语=wal
斯洛文尼亚文\ (斯洛文尼亚)=sl
阿霍姆语=aho
郎架布央语=yln
伊巴纳格语=ibg
古典藏语=xct
东波斯语=prs
北马克萨斯语=mrq
林加拉语=ln
印尼语=id
武定-禄劝彝语=ywq
汉特语=kca
廷迪语=tin
吳語=wuu
色勒库尔语=srh
波克莫尔语=nb
白俄罗斯文=be
复活节岛语=rap
挪威布克莫尔语=nb
奇加语=cgg
曼达语=mdr
萨莫吉希亚语=bat-smg
保加利亚文=bg
多尔干语=dlg
米兰德斯语=mwl
武鸣诺苏语=ywu
卢安达语=rw
华隆语=wa
傈颇语=lpo
苏丹克里奥尔阿拉伯语=pga
巴宰语=uun
克钦语=kac
南非语=af
奥里亚语=or
丘北壮语=zqe
黔东东部苗语=hmq
巴茨语=bbl
多威语=tw
阿乌语=yiu
塔克巴语=tkk
普什图语=ps
新挪威语=nn
法罗斯语=fo
索托语=st
希纳语=scl
西部彝语=ywl
克丘亚语=qu
斯万语=sva
古代北阿拉伯语=xna
阿斯图里亚斯语=ast
卡真法语=frc
坎梯语=kht
布里布里语=bzd
巴底亚语=xpr
低地文德语=dsb
阿拉伯文\ (埃及)=ar
老挝语=lo
閩南語=nan
伊比比奥语=ibb
楠榜语=ljp
傣端语=twh
卡拉恰伊-巴尔卡尔语=krc
荷兰文\ (荷兰)=nl
克罗地亚手语=csq
马巴语=mde
印地语=hi
留尼汪克里奥尔法语=rcf
瑞典文=sv
莽语=zng
阿拉伯文\ (约旦)=ar
梅鲁语=mer
赫梯语=hit
西尼日尔富拉语=fuh
勒庞蒂语=xlp
西南尼苏语=nsv
加里西亚语=gl
北美索不达米亚阿拉伯语=ayp
匈牙利文\ (匈牙利)=hu
锦语=aih
茨瓦纳语=tn
英文\ (美国)=en
赫哲语=gld
英格里亚语=izh
中文\ (中国)=zh
阿留申语=ale
南非手语=sfs
北部彝语=yiv
伦内尔手语=rsi
卡努里语=kr
奥克语=oc
塔吉克语=tg
奇卡索语=cic
拉达克语=lbj
翁布里亚语=xum
芒语=mtq
穆穆耶语=mzm
库曼语=qwm
乌孜别克语=uz
侬环语=enc
干达语=lg
明格列尔语=xmf
基尔丁-萨米语=sjd
马里语=chm
剑川白语=bca
阿拉伯文\ (伊拉克)=ar
土耳其文\ (土耳其)=tr
西班牙文\ (巴拉圭)=es
雅尼语=ahk
西班牙文\ (墨西哥)=es
卡拉伊姆语=kdr
普标语=laq
格鲁吉亚语=ka
喀尔喀蒙古语=khk
因纽特语=iu
南奄美琉球语=ams
巴塔克语=bya
阿尔及利亚手语=asp
西班牙文\ (多米尼加共和国)=es
法利希语=xfa
木雅语=mvm
卢巴卡丹加语=lu
英文\ (加拿大)=en
马赞德兰语=mzn
鄂罗克语=oaa
比尼语=bin
洛勒语=llb
信德语=sd
牙纳桑语=nio
安达曼克里奥尔印地语=hca
毕苏语=bzi
莫戈勒语=mhj
英国手语=bfi
尤比克语=uby
尼昂加语=ny
阿尔巴尼亚文\ (阿尔巴尼亚)=sq
北库尔德语=kmr
槟城手语=psg
奥地利手语=asq
与那国琉球语=yoi
基里巴斯语=gil
布吉语=bug
莫肯语=mkm
塞尔维亚文\ (黑山)=sr
奥吉布瓦语=oj
奇奥蒂语=caa
中古布列塔尼语=xbm
塔兰托语=roa-tara
贵琼语=gqi
克罗地亚文=hr
黎语=lic
豪撒语=ha
挪威手语=nsl
斯威士兰语=ss
突尼斯阿拉伯语=aeb
英语=en
安达卢西亚阿拉伯语=xaa
傣雅语=cuu
尼扬科勒语=nyn
涅涅茨语=yrk
閩東話=cdo
奇佩维安语=chp
恩加纳桑语=nio
缅甸语=my
查加泰语=chg
佛里吉亚语=xpg
圭亚那克里奥尔英语=gyn
南乌兹别克语=uzs
南皮赛恩语=spx
阿当梅语=ada
芬兰手语=fse
卡累利阿语=krl
中西伯利亚尤皮克语=ess
标敏语=bmt
赣语=gan
伊格柏语=ig
山南高卢语=xcg
楚瓦什语=cv
太鲁阁语=trv
阿法语=aa
斯洛伐克手语=svk
中文\ (香港)=zh
夸扣特尔语=kwk
果拉语=gol
卡拉塔语=kpt
宫古琉球语=mvi
卢巴-加丹加语=lu
尼加拉瓜克里奥尔英语=bzk
东山坝彝语=yik
东干语=dng
赫赫语=heh
鞑靼语=tt
蒙古手语=msr
西山坝彝语=ywt
尔苏语=ers
西部裕固语=ybe
克拉兰语=clm
奇楚瓦语=qu
库维语=kxv
巴拿语=bdq
南尼苏语=nsd
特塔姆语=tet
巴哈马克里奥尔英语=bah
滕内语=tem
却隅语=qvy
卫藏语=bo
古奥塞梯语=oos
绍纳语=sn
格列博语=grb
苏丹阿拉伯语=apd
高栏语=mlc
卢希亚语=luy
丹麦语=da
布匿语=xpu
腊克语=lbe
伊班语=iba
麻山西部苗语=hmw
德语=de
北普什图语=pbu
保安语=peh
布雷语=pce
特拉华语=del
阿拉瓦克语=arw
霍语=hoc
马来文\ (马来西亚)=ms
桂边壮语=zgn
马达加斯加手语=mzc
