#lng2name_DE
#Tue Apr 10 01:09:46 CEST 2012
Serbisch\ (Montenegro)=sr
Lepontisch=xlp
Geser-Gorom=ges
Kasachisch=kk
Dänisch\ (Dänemark)=da
Eblaitisch=xeb
Levei=tlx
Lesgisch=lez
Serer=srr
Javanisch=jv
Iwrit=he
Hethitisch=hit
Lydisch=xld
Jamdena=jmd
arabisch\ (marrokanisch)=ary
Illyrisch=xil
Dogri\ (allgemein)=doi
Mazedonisch\ (Mazedonien)=mk
Kedang=ksx
Kayupulau=kzu
Arabisch\ (Bahrain)=ar
Bislama=bi
Lavatbura-Lamusong=lbv
Gane=gzn
Gedaged=gdd
Albanisch\ (Albanien)=sq
Emilia-Romagnolo=eml
Palauanisch=pau
Sanskrit=sa
Japanische\ Zeichensprache=jsl
Chinesisch\ (Hongkong)=zh
Arabisch\ (Vereinigte\ Arabische\ Emirate)=ar
Wolio=wlo
Arabisch\ (Ostägypten)=avl
Marokkanische\ Zeichensprache=xms
Englisch\ (Neuseeland)=en
Tuvaluanisch=tvl
Futuna-Aniwa=fut
Niederländisch=nl
Spanisch\ (Argentinien)=es
Kroatische\ Zeichensprache=csq
Mori\ Bawah=xmz
Takuu=nho
Spanisch\ (Ecuador)=es
Uigurisch=ug
Baschkirisch=ba
Maranao=mrw
Estnisch\ (Estland)=et
Neapolitanisch=nap
Muna=mnb
Aserbaidschanisch=az
Griechisch\ (Zypern)=el
Moldavische\ Zeichensprache=vsi
Veneziansch=vec
Bulgarisch\ (Bulgarien)=bg
Karisch=xcr
Tupí=tpw
Eyak=eya
Arabisch\ (Irak)=yhd
Südsamisch=sma
Mandschurisch=mnc
Dalmatisch=dlm
Balinesisch=ban
Holländische\ Zeichensprache=dse
Englisch=en
Japanisch\ (Japan,JP)=ja
Chinesisch=zh
Afrikaans=af
Konkani=kok
Zentral-Maewo=mwo
Belorussisch\ (Belarus)=be
Englisch\ (Vereinigtes\ Königreich)=en
Lamogai=lmg
Rätoromanisch=rm
Spanisch\ (Uruguay)=es
Asamiya=as
Katalonische\ Zeichensprache=csc
Kosrae=kos
Sasak=sas
Kowiai=kwh
Lou=loj
Jiddisch=yi
Sango=sg
Tlingit=tli
Kroatisch\ (Kroatien)=hr
Malayische\ Zeichensprache=xml
Arabisch\ (Hijazi)=acw
Limburgisch=li
Luganda=lg
Singhalesisch=si
Maori=mi
Nogaisch=nog
Puyuma=pyu
Washoe=was
Spanisch\ (Costa\ Rica)=es
Ibanag=ibg
Saramaccaans=srm
Maithili=mai
Altburmesisch=obr
Minangkabau=min
Vai=vai
Polnisch\ (Polen)=pl
Spanisch\ (Peru)=es
Hindi\ (Indien)=hi
Englisch\ (Philippinen)=en
Bemba=bem
Kairiru=kxa
Iberisch=xib
Serbisch\ (Bosnien\ und\ Herzegowina)=sr
Bengalisch=bn
Walisisch=cy
Arabisch\ (Baharna)=abv
Katalanisch=ca
Judezmo=lad
Schweizerdeutsch=gsw
Imroing=imr
Arabisch\ (Chad)=shu
Paulohi=plh
Aragonisch=an
Mussau-Emira=emi
Telugu=te
Patpatar=gfk
Sogdisch=sog
Kasem=xsm
Inupiaq=ik
Kiribatisch=gil
Arabisch\ (Sudan)=ar
Akkadisch=akk
Roviana=rug
West-Damar=drn
Võro=vro
Marathi=mr
Gondi=gon
Chinesisch\ (Xiang)=hsn
Dolganisch=dlg
Slowakisch=sk
Pulaar=fuc
Serbisch\ (Serbien\ und\ Montenegro)=sr
Sidama=sid
Lettisch\ (Lettland)=lv
Saterfriesisch=stq
Pampango=pam
Xhosa=xh
Bikolano=bik
Rejang=rej
Madegassisch=mg
Ladinisch=lld
Koreanisch=ko
Sika=ski
Saisiyat=xsy
Bretonisch=br
Kilivila=kij
Korsisch=co
Teop=tio
Italienische\ Zeichensprache=ise
Altkoreanisch=oko
Tschechisch=cs
Fante=fat
Arabisch\ (Oman)=ar
Ibibio=ibb
Kumbrisch=xcb
Kalmückisch=xal
Ido=io
Arabisch\ (Judeo-Morokkanisch)=aju
Honduranische\ Zeichensprache=hds
Numbami=sij
Siraya=fos
Schwedisch\ (Schweden)=sv
Afrihili=afh
Lahananisch=lhn
Ostjiddisch=ydd
Wotisch=vot
Arabisch\ (Marokko)=ar
Chinook\ Wawa=chh
Südost-Babar=vbb
Anglonormannisch=xno
Schwäbisch=swg
Spanisch\ (El\ Salvador)=es
Arabisch\ (Dofari)=adf
Haitianisch=ht
Tontemboanisch=tnt
Marshallisch=mh
Udmurtisch=udm
Altchinesisch=och
Mekeo=mek
Domoinikanische\ Zeichensprache=doq
Wogeo=woc
Wandamen=wad
Süd-Paamesisch=pmz
Tahitianisch=ty
Somalisch=so
Usbekisch=uz
Nigerianische\ Zeichensprache=nsi
Hawaiianisch=haw
Tiefland-Schottisch=sco
Altkirchenslawisch=cu
Oskisch=osc
Syrisch=syr
Armenisch=hy
Embaloh=emb
Norwegisch=no
Brooke's\ Point\ Palawano=plw
Turkmenisch=tk
Galicisch=gl
Hunnisch=xhc
Ungarisch=hu
Chantisch=kca
Tschuktschisch=ckt
Venezuelanische\ Zeichensprache=vsl
Karelisch=krl
Altenglisch=ang
Italienisch\ (Italien)=it
Etruskisch=ett
Französisch\ (Kanada)=fr
Tsesisch=ddo
Esperanto=eo
Nord-Marquesanisch=mrq
Khasi=kha
Deutsche\ Zeichensprache=gsg
Nord-Sotho=nso
Tokelauanisch=tkl
arabisch\ (sudanesisch)=apd
Tigrinja=ti
Hebräisch=iw
Tsimshian=tsi
chinesisch\ (Huizhou)=czh
Tupinambá=tpn
Asturisch=ast
Neuseeländische\ Zeichensprache=nzs
Bedscha=bej
Nordsamisch=se
Krimtatarisch=crh
Ewenkisch=evn
Interlingue=ie
Hoava=hoa
Arabisch\ (Judeo-Tunesisch)=ajt
Interlingua=ia
Sizilianisch=scn
Sindhi=sd
Rennell-Belona=mnv
Tongaisch=to
Spanisch\ (Kolumbien)=es
Schweizer\ Zeichensprache=sgg
Gapapaiwa=pwg
Mandinka=man
Kolumbische\ Zeichensprache=csn
Isländisch=is
Watubela=wah
Inguschisch=inh
Französische\ Zeichensprache=fsl
Südwest-Tanna=nwi
Ewe=ee
Tatarisch=tt
Tboli=tbl
Kwara'ae=kwf
Laotisch=lo
Santali=sat
Mirandês=mwl
Mapudungun=arn
Altnordisch=non
Spanisch\ (Chile)=es
Altbretonisch=obt
Mangareva=mrv
Norwegisch\ (Norwegen)=no
Altgeorgisch=oge
chinesisch\ (Min\ Zhong)=czo
Tshivenda=ve
Sonsorolesisch=sov
Elamisch=elx
Schottisch-Gälisch=gd
Kurdisch=ku
Selaru=slu
Sabu=hvn
Ligurisch=lij
Piemontisch=pms
Niederdeutsch=nds
Vietnamesisch=vi
Arabisch\ (Standard)=arb
Kavalanisch=ckv
äthiopische\ Zeichensprache=eth
Koptisch=cop
Kulon-Pazeh=uun
Kabardinisch=kbd
Spanisch\ (Paraguay)=es
Pukapuka=pkp
Lau=llu
salvadorianische\ Zeichensprache=esn
Ost-Damar=dmr
arabisch\ (Algerien)=arq
Judeo-Arabisch=jrb
Bosnisch=bs
Arabisch\ (Libanon)=ar
Englisch\ (Australien)=en
Sundanesisch=su
Kirgisisch=ky
Pali=pi
Cherokee=chr
Altaramäisch=oar
Aymara=ay
chinesisch\ (Jinyu)=cjy
Kornisch=kw
Spanisch\ (Spanien)=es
Thai\ (Nord)=nod
Irisch=ga
Tugun=tzn
Li'o=ljl
Jamaika-Kreolisch=jam
Finnisch=fit
mongolisch\ (klassisch)=cmg
Ungarisch\ (Ungarn)=hu
Malaiisch=ms
Mittelenglisch=enm
Nias=nia
Seimat=ssg
Singapurianische\ Zeichensprache=sls
Temnisch=tem
Surinamisch=srn
Tumbuka=tum
Latein(isch)=la
Ober-Sorbisch=hsb
Nepali=ne
Tsou=tsu
Russisch=ru
Ukrainisch=uk
Talur=ilw
Aromunisch=rup
Samoanisch=sm
Kalaallisut=kl
Dhivehi=dv
Siswati=ss
Jiddische\ Zeichensprache=yds
Otjiherero=hz
Tscechische\ Zeichensprache=cse
Schwarzfuss=bla
Norwegische\ Bokmål=nb
Niedersächsisch=nds
Newari=new
Zentral-Mazahua=maz
Okzitanisch=oc
Malajalam=ml
Tsongaisch=ts
Tunjung=tjg
Buru=mhs
Singge=sne
Ainu=ain
Misima-Paneati=mpx
Hutterisch=geh
Spanisch\ (Puerto\ Rico)=es
Hiri\ Motu=ho
'Auhelawa=kud
Ugaritisch=uga
(Alt-)Preußisch=prg
Santa\ Ana=stn
Kove=kvc
Akan=ak
Sekar=skz
Kanakanabu=xnb
Japanisch=ja
Hitu=htu
Arabisch\ (Ägypten)=ar
Arabisch\ (Jemen)=ar
Deutsch\ (Schweiz)=de
Sardisch=sc
Filipinisch=fil
brasilianische\ Zeichensprache=bzs
Irisch\ (Irland)=ga
Dänische\ Zeichensprache=dsl
Muduapa=wiv
Tagalog=tl
Skoltsamisch=sms
Karaimisch=kdr
Shona=sn
Guanche=gnc
Kinyarwanda=rw
Tamilisch=ta
Tok\ Pisin=tpi
Mari=chm
Quenya=qya
Ga=gaa
Galatisch=xga
Persisch=fa
Ontong\ Java=ojv
Kaschubisch=csb
Weißrussisch=be
Ivatan=ivv
Englisch\ (Indien)=en
Fränkisch=frk
Tschagataisch=chg
Lykisch=xlc
Inarisamisch=smn
Oriya=or
Ingrisch=izh
Spanisch\ (Nicaragua)=es
Isländische\ Zeichensprache=icl
Tikopia=tkp
Spanisch\ (Bolivien)=es
Saposa=sps
Baskisch=eu
Romani=rom
Mengen=mee
Fidschianisch=fj
Pandschabisch=pa
Arabisch\ (Algerische\ Sahara)=aao
Sumerisch=sux
Jakutisch=sah
Koreanisch\ (Südkorea)=ko
Griechisch\ (?)=cpg
Karatschai-Balkarisch=krc
Lombardisch=lmo
Vietnamesisch\ (Vietnam)=vi
Ili'uun=ilu
Südost-Ambrym=tvk
Amharisch=am
Kerinci=kvr
Maisin=mbq
Arabisch\ (Lybien)=ayl
Englisch\ (Irland)=en
Phönizisch=phn
Türkisch\ (Türkei)=tr
Arabisch\ (mesopotamisch)=acm
Hausa=ha
Englisch\ (Singapur)=en
Russisch\ (Russland)=ru
Selkupisch=sel
Deutsch\ (Deutschland)=de
Spanisch\ (Venezuela)=es
Nehan=nsn
Gela=nlg
Aserbaidschanisch\ (Nord-)=azj
Waray-Waray=war
Kölsch=ksh
Manx=gv
Schlesisch=sli
Französisch\ (Belgien)=fr
Portugiesisch=pt
Pohnpeianisch=pon
Jordanische\ Zeichensprache=jos
Finnisch\ (Finnland)=fi
Ewenisch=eve
Maltesisch\ (Malta)=mt
Chinesisch\ (Singapur)=zh
Nieder-Sorbisch=dsb
Navajo=nv
Penrhyn=pnh
Unserdeutsch=uln
Slowenisch=sl
Chaladschische\ Sprache=kjf
Rukai=dru
Arabisch\ (Jordanien)=ar
Ägyptisch=egy
Afar=aa
Thao=ssf
Mittelfranzösisch=frm
Kapingamarangi=kpg
Italienisch\ (Schweiz)=it
Nyanja=ny
Kambera=xbr
pontisch=pnt
Caló=rmr
Ost-Masela=vme
Altfriesisch=ofs
Albanisch=sq
Chamorro=ch
arabisch\ (Nadji)=ars
Hano=lml
Nord-Efate=llp
Portugiesisch\ (Portugal)=pt
Litauisch=lt
Deutsch=de
Mongolisch=mn
Jawe=jaz
Ilokano=ilo
Türkisch=tr
Manggarei=mqy
(keine)=zxx
Arabisch\ (Libyen)=ar
Westfriesisch=fy
Ungarische\ Zeichensprache=hsh
Berta=wti
Massai=mas
Irarutu=irh
Mozambikanische\ Zeichensprache=mzy
Altirisch=sga
Französisch\ (Frankreich)=fr
Arabisch\ (Kuwait)=ar
Griechisch=el
Sengseng=ssz
Chinesische\ Zeichensprache=csl
Niederländisch\ (Belgien)=nl
Komi=kv
Osmanisch=ota
Leipon=lek
Ostfriesisch=frs
Wanukaka=wnk
Nordfriesisch=frr
Englisch\ (Vereinigte\ Staaten\ von\ Amerika)=en
Lampung=ljp
Mazedonisch=mk
Mittelkoreanisch=okm
Arabisch\ (Syrien)=ar
Mittelhochdeutsch=gmh
estonische\ Zeichensprache=eso
Englisch\ (Kanada)=en
Chakassische\ Sprache=kjh
Costa\ Ricanische\ Zeichensprache=csr
Tohono\ O'odham=ood
Korjakische\ Sprache=kpy
Tschetschenisch=ce
Waropen=wrp
Nepalesische\ Zeichensprache=nsp
Ossetisch=os
Litauisch\ (Litauen)=lt
Motu=meu
Karolinisch=cal
Hebräisch\ (Israel)=iw
Kunama=kun
Roro=rro
Igbo=ig
Kabylisch=kab
Ukrainisch\ (Ukraine)=uk
Sesotho=st
Tschechisch\ (Tschechische\ Republik)=cs
Abasinisch=abq
Lulesamisch=smj
Mota=mtt
Englisch\ (Malta)=en
Altpersisch=peo
Arabisch\ (Saudi-Arabien)=ar
Gujarati=gu
Yami=tao
Caddo=cad
Arabisch\ (Katar)=ar
Volapük=vo
Tigak=tgc
Kumykisch=kum
Kachin=kac
Mansisch=mns
Rotumanisch=rtm
Schwedisch=sv
ägyptische\ Zeichensprache=esl
Französisch\ (Luxemburg)=fr
Russische\ Zeichensprache=rsl
Dobu=dob
Indonesische\ Zeichensprache=inl
arabisch\ (Judeo-Jemenitisch)=jye
Nenema=nee
Norwegisch\ (Norwegen,Nynorsk)=no
arabisch\ (Nord\ Levantisch)=apc
Manipuri=mni
Belorussisch=be
Dioula=dyu
(Mehrere)=mul
Varisi=vrs
Tuwinisch=tyv
Mambae=mgm
Persisch\ (Dari)=prs
Fur=fvr
To'abaita=mlu
Ghanische\ Zeichensprache=gse
Darginisch=dar
Ful=ff
Serbisch=sr
Altmazedonisch=xmk
Eteokretisch=ecr
Cebuano=ceb
Chipewyan=chp
Spanisch\ (Dominikanische\ Republik)=es
Nauruisch=na
Slowenisch\ (Slowenien)=sl
Maltesisch=mt
Karakalpakisch=kaa
Mokschanisch=mdf
Tuamotuanisch=pmt
Gebe=gei
Nieuanisch=niu
Portugiesisch\ (Brasilien)=pt
Spanisch\ (Guatemala)=es
Arabisch\ (Tadschikistan)=abh
Modang=mxd
Gagausisch=gag
Dzongkha=dz
Rapanui=rap
Tadschikisch=tg
Ujir=udj
Termanu=twu
Zimbern=cim
Chilenische\ Zeichensprache=csg
Ngad'a=nxg
Spanisch\ (Panama)=es
Ubir=ubr
Spanisch\ (Vereinigte\ Staaten\ von\ Amerika)=es
Papiamentu=pap
Wepsisch=vep
Deutsch\ (Luxemburg)=de
Tetun=tet
ecuadorianische\ Zeichensprache=ecs
Gayo=gay
Slowakisch\ (Slowakei)=sk
Peruanische\ Zeichensprache=prl
Rarotonganisch=rar
Chorasan-türkische\ Sprache=kmz
kurdisch=ckb
Vaghua=tva
So'a=ssq
Bhojpuri=bho
Serbisch\ (Serbien)=sr
Umbrisch=xum
Mono=mnr
Alt-Griechisch=grc
Französisch\ (Schweiz)=fr
Hopi=hop
arabisch\ (ägyptisch)=arz
Jatwingisch=xsv
Kurisch=xcu
Ugandische\ Zeichensprache=ugn
Atayal=tay
Mouk-Aria=mwh
Klingonisch=tlh
Suaheli=sw
Indische\ Zeichensprache=ins
Indonesisch=id
Arabisch\ (Nordmesopotamien)=ayp
Judeo-Berberisch=jbe
Indonesisch\ (Indonesien)=in
Quechua=qu
Albanisch\ (Tosk)=als
Teanu=tkw
Englisch\ (Südafrika)=en
Arabisch\ (Zypern)=acy
Wampar=lbq
Tela-Masbuar=tvm
Kodi=kod
Färöisch=fo
Chinesisch\ (China)=zh
Kikuyu=ki
Friaulisch=fur
Polnisch=pl
Krio=kri
Kis=kis
Altprovençalisch=pro
Vlax\ Romani=rmy
Saaroa=sxr
Rumänisch\ (Rumänien)=ro
Kannada=kn
Italienisch=it
Nynorsk=nn
chinesisch\ (Ming\ Dong)=cdo
West-Bukidnon-Manobo=mbb
Griechische\ Zeichensprache=gss
Kikongo=kg
Krimtschakisch=jct
Suau=swp
Urdu=ur
Lojban=jbo
Keltiberisch=xce
Ersjanisch=myv
Spanisch\ (Honduras)=es
Chamula-Tzotzil=tzc
Wallonisch=wa
Albanisch\ (Gheg)=aln
Rumänisch=ro
Ukrainische\ Zeichensprache=ukl
Buduchisch=bdk
Französisch=fr
Althochdeutsch=goh
Arabisch\ (Südlevantisch)=ajp
Ghari=gri
finnische\ Zeichensprache=fse
Tsuana=tn
Nukuoro=nkr
Kapverdisch=kea
Gotisch=got
Deutsch\ (Österreich)=de
Luxemburgisch=lb
Tobianisch=tox
Meroitisch=xmr
Mamboru=mvd
Arabisch\ (Uzbekistan)=auz
Lettisch=lv
Plautdietsch=pdt
Kashmiri=ks
Georgisch=ka
Mòoré=mos
Serbokroatisch=sh
Guaraní=gn
Livisch=liv
Kanuri=kr
Lamboya=lmy
Spanisch=es
Estnisch=et
Flämisch=vls
Niederländisch\ (Niederlande)=nl
Abchasisch=ab
Judeo-Persisch=jpr
Wolof=wo
Lenakel=tnl
Tschuwaschisch=cv
Kroatisch=hr
Chuukesisch=chk
Griechisch\ (Griechenland)=el
Tibetisch=bo
Gorontalo=gor
Maduresisch=mad
Bulgarisch=bg
Wejewa=wew
Twi=tw
Südaltaisch=alt
Ririo=rri
Thai(ländisch)=th
Ngaju=nij
Aramäisch=arc
Chinesisch\ (Taiwan)=zh
Sikaiana=sky
Tae'=rob
Mele-Fila=mxe
Paschtunisch=ps
Lingala=ln
Sobei=sob
Mohawk=moh
Taroko=trv
Wuvulu=wuv
Inuktitut=iu
Aukaans=djk
Altfranzösisch=fro
Japanisch\ (Japan)=ja
Mongondow=mog
Quebec\ Zeichensprache=fcs
Burmesisch=my
Arabisch=ar
Faliskisch=xfa
Makassar=mak
Isländisch\ (Island)=is
Kisar=kje
Russinisch=rue
Süd-Efate=erk
Hindi=hi
Polabisch=pox
Istriotisch=ist
Lamaholot=slp
Hakka=hak
Lozi=loz
Arabisch\ (Sanaani)=ayn
Guineanische\ Zeichensprache=gus
Guatemala\ Zeichensprache=gsm
Bayerisch=bar
Bari=bfa
Dänisch=da
Rumänische\ Zeichensprache=rms
Kirundi=rn
Komipermjakisch=koi
arabisch\ (Hadrami)=ayh
Arabisch\ (Tunesien)=ar
Timugon\ Murut=tih
Arabisch\ (Algerien)=ar
Sindarin=sjn
Katalanisch\ (Spanien)=ca
Oromo=om
Spanisch\ (Mexiko)=es
