#lng2name_ES
#Tue Apr 10 01:09:46 CEST 2012
rutul=rut
remo=rem
hausa=ha
javanés=jv
inguso=inh
palauano=pau
malayo\ (Malasia)=ms
pirahã=myp
chino\ mandarín=cmn
español\ (Perú)=es
alemán\ (Austria)=de
tahitiano=ty
rundí=rn
lituano=lt
dolgan=dlg
aguacateco=agu
inglés\ (Sudáfrica)=en
pémono=pev
coreano\ (Corea\ del\ Sur)=ko
rumano\ (Rumania)=ro
assiniboine=asb
pech=pay
tagalo(g)=tl
tupí=tpw
irlandés\ (Irlanda)=ga
karok=kyh
anambé=aan
árabe\ (Yemen)=ar
dakota=dak
xabixí=xbx
griego\ antiguo=grc
sateré-mawé=mav
kanauji=bjj
cabilio=kab
tigriña=ti
español\ (México)=es
tabassaran=tab
chino\ (Taiwán)=zh
maskoki=mus
japonés\ (Japón)=ja
akhvakh=akv
árabe\ (Argelia)=ar
nipode=hux
avá-canoeiro=avv
konda=knd
archi=aqc
chamorro=ch
mikasuki=mik
franco-provenzal=frp
español=es
lengua\ de\ signos\ española=ssp
venda=ve
filipino=fil
indonesio=id
malayo=ms
portugués\ (Brasil)=pt
kirguís=ky
chino\ (Singapur)=zh
chatino\ de\ Tataltepec=cta
janti=kca
tofa=kim
wayampi=oym
manipurí=mni
orejón=ore
maltés\ (Malta)=mt
estonio\ (Estonia)=et
chontal\ de\ Tabasco=chf
gagauzo=gag
tepehua\ de\ Pisaflores=tpp
chhattisgarhí=hne
kurdo=ku
potiguára=pog
gilbertés=gil
guambiano=gum
ópata=opt
esloveno=sl
español\ (El\ Salvador)=es
griego\ (moderno)=el
uigur=ug
yakuto=sah
amahuaca=amc
lezguio=lez
guajá=gvj
ojibwa=oj
sardo=sc
tzotzil\ zinacanteco=tzz
persa=fa
sueco=sv
ge'ez=gez
turco-otomano=ota
español\ (Guatemala)=es
udmurto=udm
pawnee=paw
kumiai=dih
votio=vot
chinook=chh
pauserna=psm
wayúu=guc
tsonga=ts
francés\ medio=frm
escocés=sco
español\ (España)=es
arára,\ pará=aap
nepalí=ne
andaquí=ana
camsá=kbh
livonio=liv
aghul=agx
quapaw=qua
judeo-tat=jdt
kuruáya=kyr
chiripá=nhd
judeo-italiano=itk
cree=cr
tamanaku=tmz
japonés=ja
kaxararí=ktx
caddo=cad
oseto=os
seneca=see
laco=lbe
macedonio\ (Macedonia)=mk
bhojpurí=bho
fangüé=fan
croata=hr
korwa=kfp
húngaro\ (Hungría)=hu
aragonés=an
asamés=as
mansi=mns
oneida=one
ido=io
tailandés\ (Tailandia)=th
vietnamita\ (Vietnam)=vi
tapieté=tpj
macedonio=mk
bora=boa
español\ (Bolivia)=es
bajo\ sajón=nds
juang=jun
cinta\ larga=cin
tulu=tcy
hixkaryána=hix
hupdë=jup
lengua\ de\ señas\ argentina=aed
inglés\ (India)=en
alemán=de
laal=gdm
tongano=to
rayastaní=raj
árabe=ar
guayabero=guo
aché=guq
quiché\ central=quc
checo\ (Chequia)=cs
dzongkha=dz
tibetano=bo
piro=pie
panobo=pno
patamona=pbc
sonés=sn
omurano=omu
chatino\ de\ Zenzontepec=czn
provenzal\ antiguo=pro
arhuaco=arh
cogui=kog
sesotho=st
cubeo=cub
fin(land)és=fi
biloxi=bll
nauruano=na
occitano=oc
karitiâna=ktn
árabe\ (Túnez)=ar
volapük=vo
morerebi=xmo
elamita=elx
salumá=slj
tepehuano\ septentrional=ntp
serbio\ (Serbia\ y\ Montenegro)=sr
ciriano=kpv
canarés=kn
noruego\ bokmål=nb
herero=hz
onondaga=ono
kikapú=kic
macusí=mbc
inglés=en
tuparí=tpr
malayalam=ml
ñanya=ny
italiano\ (Italia)=it
español\ (Panamá)=es
cheyén=chy
xipaya=xiy
luxemburgués=lb
sindí=sd
árabe\ (Sudán)=ar
matsés=mcf
serbio=sr
oro\ win=orw
italiano\ (Suiza)=it
armenio=hy
amárico=am
chachi=cbi
cebuano=ceb
eñepa=pbh
chuvasio=cv
barasana=bsn
budukh=bdk
guaraní\ mbyá=gun
xipináwa=xip
ruandés=rw
quenya=qya
acano=ak
guanano=gvc
polaco\ (Polonia)=pl
pochuteco=xpo
tuyuka=tue
fi(d)jiano=fj
mayo=mfy
beté=byf
antiguo\ nórdico=non
hmar=hmr
baskir=ba
abjaso=ab
sepedi=nso
miskito=miq
catalán=ca
tailandés\ (Tailandia,TH)=th
hiligainón=hil
español\ (Puerto\ Rico)=es
tutelo=tta
chatino\ de\ la\ zona\ alta\ oriental=cly
turco=tr
jakas=kjh
katukína=knt
shinabo=snh
húngaro=hu
klamath-modoc=kla
indeterminada=und
noruego\ (Noruega)=no
vietnamita=vi
xetá=xet
griego\ (Chipre)=el
hidatsa=hid
mam\ central=mvc
massaï=mas
árabe\ (Jordania)=ar
albanés\ (Albania)=sq
inglés\ (Nueva\ Zelanda)=en
tártaro=tt
chimila=cbg
guarayú=gyr
omagua=omg
quechua=qu
ruso\ (Rusia)=ru
chimariko=cid
hebreo\ (Israel)=iw
cacaopera=ccr
koya=kff
jemer=km
emerillon=eme
nadëb=mbj
guyaratí=gu
islandés\ (Islandia)=is
cakchiquel\ central=cak
somalí=so
alemán\ (Suiza)=de
tanimuca-retuarã=tnc
corso=co
flamenco=vls
navajo=nv
paranawát=paf
español\ (Argentina)=es
pokangá=pok
kalmyk=xal
georgiano=ka
khvarshi=khv
kaxuiâna=kbb
tubar=tbu
bengalí=bn
ikpeng=txi
apalaí=apy
korku=kfq
tepecano=tep
suano=sva
carelio=krl
serbocroata=sh
andí=ani
coreano=ko
nukuini=nuc
inuktitut=iu
tripuri=xtr
portugués=pt
egipcio=egy
maithili=mai
feroés=fo
cashinahua=cbs
hindú\ (India)=hi
eslovenio\ (Eslovenia)=sl
aushiri=avs
guaraní\ paraguayo=gug
suahelí=sw
naskapi=nsk
serrano=ser
marwari=mwr
bacairí=bkq
hindi=hi
stoney=sto
shasta=sht
francés\ (Bélgica)=fr
kaiwá=kgk
ižoriano=izh
chaima=ciy
awetí=awe
árabe\ (Arabia\ Saudita)=ar
cachemir=ks
oromo=om
francés=fr
chiapaneco=cip
hinukh=gin
suruí\ do\ Pará=mdz
bosnio=bs
bodo=brx
mari=chm
tetete=teb
kanoé=kxo
menominee=mez
sueco\ (Suecia)=sv
magahi=mag
ladino=lld
kansa=ksk
laosiano=lo
swati=ss
neerlandés\ (Bélgica)=nl
tapirapé=taf
ixcateco=ixc
quicuyú=ki
avaro=av
murui=huu
poyanáwa=pyn
arikem=ait
cahuilla=chl
ladakhi=lbj
abaza=abq
rumano=ro
bielorruso=be
árabe\ (Qatar)=ar
español\ (Honduras)=es
maorí=mi
arameo=arc
volofo=wo
mingrelio=xmf
wichita=wic
ngäbere=gym
tiwi=tiw
francés\ (Francia)=fr
persa\ antiguo=peo
casubio=csb
kiowa=kio
tiwa=lax
tehuelche=teh
shipibo-conibo=shp
eslovaco\ (Eslovaquia)=sk
inglés\ (Filipinas)=en
sherpa=xsr
tamil=ta
seri=sei
mordvino=myv
friulo=fur
bielorruso\ (Bielorrusia)=be
español\ (República\ Dominicana)=es
samoano=sm
sranan=srn
limbu=lif
rama=rma
inglés\ medio=enm
indonesio\ (Indonesia)=in
kinnauri=kfk
bajo\ sorbio=dsb
gabrieleño-fernandeño=xgf
pies\ negros=bla
extremeño=ext
mapudungun=arn
napolitano=nap
suruí=sru
sudoviano=xsv
kashibo-kakataibo=cbr
retorrománico=rm
siona=snn
karapaná=cbc
serbio\ (Montenegro)=sr
afrikaans=af
árabe\ (Emiratos\ Árabes\ Unidos)=ar
bagvalal=kva
amundava=adw
anal=anm
afar=aa
chino\ (China)=zh
nogay=nog
sharanahua=mcd
sango=sg
bislama=bi
efé=ee
bezhta=kap
karata=kpt
neerlandés\ medio=dum
tarahumara\ central=tar
caló=rmr
minica=hto
danés=da
guaraní\ boliviano\ occidental=gnw
aruá=arx
adigué=ady
tuscarora=tus
nottoway=ntw
jasí=kha
chocho=coz
tenharim=pah
sundanés=su
urartiano=xur
klingon=tlh
nyamwezi=nym
árabe\ (Libia)=ar
criollo\ haitiano=ht
francés\ (Suiza)=fr
inglés\ (Irlanda)=en
vasco=eu
hawaiano=haw
bemba=bem
micmac=mic
kui=kxu
fenicio=phn
atsawaka=atc
guaraní=gn
sirionó=srq
árabe\ (Bahráin)=ar
latín=la
piamontés=pms
turcomano=tk
koasati=cku
cocama-cocamilla=cod
español\ (Ecuador)=es
pakaásnovos=pav
setsuana=tn
beja=bej
boruca=brn
komi=kv
hatti=xht
haryanví=bgc
copto=cop
akurio=ako
kryts=kry
isconahua=isc
shawnee=sjw
iowa-oto=iow
botlikh=bph
amanayé=ama
sakirabiá=skf
gondi=gon
ghodoberi=gdo
asuriní\ xingú=asn
chino\ (Hong\ Kong)=zh
maricopa=mrc
falisco=xfa
konkani=kok
aimara=ay
xhosa=xh
picardo=pcd
lingala=ln
español\ (Uruguay)=es
cabécar=cjp
árabe\ (Iraq)=ar
tlingit=tli
finés\ (Finlandia)=fi
maratí=mr
lenguaje\ de\ señas\ americano=ase
dogri=doi
azerbayano=az
veneciano=vec
igbo=ig
luganda=lg
pemón=aoc
judeo-persa=jpr
hunzib=huz
inglés\ (Australia)=en
paipai=ppi
yaundé=ewo
bhili=bhb
tayiko=tg
árabe\ (Líbano)=ar
alemán\ (Alemania)=de
arapaho=arp
árabe\ (Siria)=ar
udi=udi
pokomam\ central=poc
osco=osc
savara=svr
delaware=del
umbro=xum
cofán=con
ocaina=oca
acadio=akk
wiyot=wiy
púnico=xpu
mapoyo=mcg
popoluca\ de\ Texistepec=poq
chibcha=chb
shor=cjs
letón\ (Letonia)=lv
panyabí=pa
mondé=mnd
sánscrito=sa
sensi=sni
noruego\ (Noruega,Nynorsk)=no
interlingue=ie
bretón=br
khinalugh=kjj
cahuarano=cah
interlingua=ia
árabe\ (Marruecos)=ar
inupiaq=ik
karipúna=kgm
checo=cs
lazo=lzz
shina=scl
kazaj(i)o=kk
tártaro\ de\ Crimea=crh
muinane=bmr
maquiritare=mch
guaraní\ boliviano\ oriental=gui
vepsio=vep
mongol=mn
kotava=avk
jalaj=klj
tindi=tin
árabe\ (Kuwait)=ar
mal(a)gache=mg
awá=awb
tucano=tuo
carijona=cbd
alto\ sorbio=hsb
uzbeco=uz
inglés\ (Canadá)=en
itene=ite
tigré=tig
Idioma\ turco\ de\ Jorasán=kmz
lakota=lkt
inglés\ (Singapur)=en
bundeli=bns
lituano\ (Lituania)=lt
danés\ (Dinamarca)=da
tsimshian=tsi
totonaco\ de\ Papantla=top
kekchí=kek
tsakhur=tkr
cochimí=coj
cayuga=cay
árabe\ (Omán)=ar
inglés\ (Malta)=en
mohawk=moh
alabama=akz
chatino\ de\ Zacatepec=ctz
ucrani(an)o=uk
groenlandés=kl
cheroqui=chr
mono=mnr
birmano=my
español\ (Costa\ Rica)=es
córnico=kw
chiquitano=cax
noruego\ nynorsk=nn
karaim=kdr
matagalpa=mtn
popoluca\ de\ Sayula=pos
mohave=mov
mixe\ de\ Juquila=mxq
manés=gv
santalí=sat
polaco=pl
kawaiisu=xaw
omaha-ponca=oma
tailandés=th
catalán\ (España)=ca
islandés=is
asturiano=ast
koda=cdz
cupeño=cup
gallego=gl
arabela=arl
atruahí=atr
español\ (Estados\ Unidos)=es
kiliwa=klb
yora=mts
tepehua\ de\ Tlachichilco=tpt
talish=tly
mirandés=mwl
luiseño=lui
jaria=khr
serbio\ (Serbia)=sr
pisabo=pig
dargínico=dar
mundurukú=myu
francés\ (Canadá)=fr
lombardo=lmo
puinave=pui
montañés=moe
curonio=xcu
ucranio\ (Ucrania)=uk
toraz=trz
póntico=pnt
zo'é=pto
español\ (Colombia)=es
laurentiano=lre
tupinikin=tpk
coos=csz
japonés\ (Japón,JP)=ja
haida=hai
karakalpako=kaa
colorado=cof
ugarítico=uga
euskera=eu
kamayurá=kay
papiamento=pap
puruborá=pur
ho=hoc
eslovaco=sk
jorá=jor
washo=was
meglenorrumano=ruq
letón=lv
popoluca\ de\ Oluta=plo
francés\ antiguo=fro
paiute\ septentrional=pao
maring=mbw
makuráp=mpu
selkup=sel
pápago=ood
español\ (Chile)=es
awadhi=awa
piratapuyo=pir
eslavo\ eclesial=cu
jandeshi=khn
barí=mot
ubijé=uby
chortí=caa
inglés\ (Reino\ Unido)=en
neerlandés\ (Holanda)=nl
subtiaba=sut
mandan=mhq
pima\ bajo=pia
telugú=te
pityantyatyara=pjt
albanés=sq
iquito=iqu
takelma=tkm
chamalal=cji
irlandés\ antiguo=sga
ruso=ru
natchez=ncz
guajajára=gub
drehu=dhv
Urdu=ur
uru-eu-wau-wau=urz
neerlandés=nl
asuriní=asu
italiano=it
karipuná=kuq
español\ (Nicaragua)=es
pohnpei=pon
kepkiriwát=kpn
noruego=no
judeo-español=lad
judeo-arabé=jrb
lepcha=lep
matipuhy=mzo
tukumanféd=tkf
Karajá=kpj
esperanto=eo
vaiphei=vap
ligur=lij
galés=cy
lusai=lus
jerga\ chinook=chn
curuj=kru
zapoteco\ antiguo=xzp
tupinambá=tpn
tatuyo=tav
aromùnico=rup
choctaw=cho
kumyko=kum
conestog=sqn
árabe\ (Egipto)=ar
chatino\ de\ la\ zona\ alta\ occidental=ctp
checheno=ce
hebreo=iw
dalmático=dlm
jaqaru=jqr
twi=tw
lahnda=lah
kuikúro-kalapálo=kui
maltés=mt
español\ (Venezuela)=es
estonio=et
francés\ (Luxemburgo)=fr
cuiba=cui
canurí=kr
mobilio=mod
hodï=hti
serbio\ (Bosnia\ y\ Hercegovina)=sr
maritsauá=msp
andoa=anb
griego\ (Grecia)=el
inglés\ (Estados\ Unidos)=en
balinés=ban
machiguenga=mcb
salar=slr
tembé=tqb
osage=osa
maldivo=dv
bikol=bik
wayoró=wyr
chickasaw=cic
bribri=bzd
lozi=loz
irlandés=ga
sumerio=sux
wyandot=wya
gótico=got
crow=cro
búlgaro=bg
secoya=sey
tacaneco=mtz
urubú-kaapor=urb
sauk=skc
mozárabe=mxi
karachay-balkar=krc
cabardiano=kbd
sikiana=sik
nicobarés\ central=ncb
prusiano\ (antiguo)=prg
zemgaliano=xzm
bávaro=bar
gaélico\ escocés=gd
emiliano-romañolo=eml
alemán\ (Luxemburgo)=de
cingalés=si
jurúna=jur
irlandés\ medio=mga
cumanagoto=cuo
chino=zh
oriya=or
esselen=esq
pai\ tavytera=pta
potawatomi=pot
búlgaro\ (Bulgaria)=bg
miwok\ costanoano=csi
kákwâ=keo
tinigua=tit
turiwára=twt
kayabí=kyz
japrería=jru
araweté=awt
apiacá=api
croata\ (Croacia)=hr
kongo=kg
español\ (Paraguay)=es
tepehua\ de\ Huehuetla=tee
altay=alt
gavião\ do\ Jiparaná=gvo
istrorrumano=ruo
chatino\ de\ Nopala=cya
júma=jua
bácico=bbl
turco\ (Turquía)=tr
tewa=tew
siciliano=scn
portugués\ (Portugal)=pt
pastú=ps
